"Frontside"	"Flipside"	"Category"
'ampi	katsuma, puutuma	vtr.
'angtsìk	Vasarpea (hammerhead)	n.
'aw	üks	num.
'awkx	kalju, järsak	n.
'awpo	keegi, üks isik	pn.
'awsiteng	koos	adv.
'awve	esimene	adj.
'e'al	halvim	adj.
'eko	ründama	vtr.
'ekong	biit, löök (muusikas)	n.
'engeng	tase	adj.
'eveng	laps	n.
'evi	lapseke (affectionate form of)	n.
'ewan	noor	adj.
'eylan	sõber	n.
'ì'awn	jääma, püsima	vin.
'ìheyu	spiraal	n.
'Ìnglìsì	inglise keel	n.
'it	väike kogus	n.
'itan	poeg	n.
'ite	tütar	n.
'ok	mälestamine	n.
'ong	õitsema	v.
'u	asi (ese, fakt, mõte)	n.
'upe	mis (asi)	inter.
'upxare	sõnum, teade	n.
a	see (,mis), kes	part.
alaksi	valmis	adj.
lìm	kaugel olema	svin.
apxa	suur	adj.
atan	valgus	n.
atokirina'	Püha Puu seemned	n.
atxkxe	maa	n.
au	trumm (valmistatud nahast)	n.
aungia	märk, enne	n.
awaiei	Paradiisi mardus (banshee of paradise)	n.
awnga	meie	pn.
ayfo	nemad	pn.
aynga	teie	pn.
ayoe	meie (välistav)	pn.
ayoeng	meie (kaasav) (ayoeng nimetavas, (meie ja sina))	pn.
äie	nägemus (vaimne)	n.
äo	all, allpool	adp.
ätxäle	palve, nõue	n.
ätxäle si	nõudma, paluma (koos tsnì osalausega sihitise jaoks)	vin.
ean	sinine, roheline	adj.
eltu	aju	n.
eltu si	tähele panema, (kellegi) segamist lõpetama	vin.
eltungawng	Uneuss (brainworm)	n.
emza'u	läbima (testi), üle saama	vtr.
eo	ees, millegi ees	adp.
eyawr	õige, veatu	adj.
eyaye	Surmasulg (warbonnet)	n.
eyk	juhtima, valitsema	vtr.
eyktan	valitseja	n.
fa	koos (millegagi), (millegi) abil	adp.
fahew	lõhn, hais	n.
fìfya	nii, niimoodi	adv.
fìkem	see (tegevus)	pn.
fìpo	see (isik või asi)	pn.
fìtxan	nii palju	adv.
fìtseng	siin, selles kohas, see koht	adv., n.
fìtsenge	siin, selles kohas, see koht	adv., n.
fì'u	see (asi)	pn.
fkarut	koorima	v.
fkew	vägev, võimas	adj.
fko	üks, nemad, see, umbisikuline tegija	pn.
flä	õnnestuma, korda minema	vin.
fmawn	uudis, miski millest teavitada	n.
fmetok	katsetama	vtr.
fmi	püüdma, üritama	vtrm.
fngap	metall	n.
fngapsutxwll	Metalli järgiv taim (metalfollowing plant)	n.
fnu	vaikima, vait olema	vin.
fo	nemad	pn.
fpak	tagasi hoidma, peatama tegevust	v.
fpe'	saatma	vtr.
fpeio	väljakutse, ülesanne (tseremoniaalne)	n.
fpi	(millegi) pärast, tõttu  (Ma tapan jumala pärast. Eesti keeles eraldi väljend tegelikult puudub.)	adp.
fpìl	mõtlema, arvama	vtr.
fpom	heaolu, õnnelikkus, rahu	n.
fpxafaw	Lendmeduus (medusa)	n.
fpxäkìm	sisenema	vin.
fra'u	iga asi/ese	pn.
frakrr	alati, koguaeg	adv.
frapo	igaüks, kõik	pn.
frrfen	külastama	vtr.
frrtu	külaline, külastaja	n.
ftang	peatuma	vim.
fte	(nii), et; (selleks), et	conj.
fteke	(nii) et mitte, et ei	conj.
ftia	õppima	vtr.
ftxì	keel (kehaosa)	n.
ftxozä	tähistus, tore sündmus, puhkus	n.
ftu	seestütlev kääne (suund)	adp.
ftue	lihtne, kerge	adj.
ftxavang	kirglik, püüdlik	adj.
ftxey	valima, valikut tegema	vtr.
fu	või	conj.
futa	seda, mis (kõrvallause märkija)	pn., sbd.
fwa	see, mis (kõrvallause märkija)	pn., sbd.
fya'o	tee, rada, komme, viis	n.
fyape	kuidas	inter.
fyawìntxu	juhatama, teed näitama	vin.
ha	sel juhul, siis	adv.
hahaw	magama	vin.
hapxì	osa, tükk	n.
hasey	tehtud, lõpetatud, valmis	adj.
hawnu	kaitsma, varjama	vtr.
hì'i	väike	adj.
hiyìk	naljakas, imelik, veider	adj.
hol	natuke	adj.
holpxay	number	n.
hrrap	oht	n.
hu	koos (kellegagi)	adp.
hufwe	tuul	n.
hum	lahkuma, ära minema	vin.
i'en	keelpill	n.
ikran	Mardus, Ikran (banshee)	n.
ikranay	Metsmardus (forest banshee)	n.
ioang	loom, elukas	n.
irayo	aitäh, tänud	n., intj.
ìlä	(millegi, kellegi) kaudu, läbi	adp.
ka	üleni	adp.
kä	minema	vin.
kali'weya	mürgise ämbliku liik	n.
kalin	hea maitsega	adj.
kaltxì	tere	intj.
kämakto	välja lendama/ratsutama/sõitma	v.
kame	nägema, sisse nägema, aru saama, teadma (vaimne)	vtr.
kan	sihtima, suunama; suunitlema, kavatsema	vtrm., vtr.
kangay	kehtiv, tõene	adj.
kar	õpetama	vtr.
karyu	õpetaja	n.
kato	rütm	n.
kawkrr	mitte kunagi	adv.
kawng	paha, kuri	adj.
kawtu	mitte keegi	pn.
ke	mitte	adv.
ke'u	mitte midagi	pn.
kehe	ei	part., intj.
kelku	kodu, maja	n.
kelku si	elama, paiknema	vin.
kem	tegevus, tegu	n.
kempe	mis (tegevus)	inter.
kenong	kujutama, esindama, näiteks olema (e)	vin.
kerusey	surnud	adj.
ketuwong	võõras isik	n.
kewong	võõras	adj.
keye'ung	hullumeelsus	n.
kifkey	maailm (füüsiline, tahke)	n.
kilvan	jõgi	n.
kìm	keerlema, keerutama (midagi); Pol rumit kolìm  ta keerutas palli	vtr.
kin	vajama	vtr.
kinam	jalg	n.
kinamtil	põlv	n.
kìng	niit, lõng	n.
kip	(kellegi) hulgas	adp.
kìte'e	teenus, teenistus	n.
kllfro'	vastutav olema	svin.
kllkulat	kaevama	vtr.
kllkxem	seisma	vin.
kllpxìltu	territoorium, maaala	n.
kllte	maa, maapind	n.
ko	pealesurutud nõustumine (eks)	part.
kop	ka, samuti, lisaks	adv.
koren	reegel, juhtnöör	n.
krr	aeg	n.
krrnekx	aega võtma/nõudma (e)	vin.
krrpe	millal (mis ajal)	inter.
kunsìp	lahingulaev	n.
kurakx	välja sõitma	vtr.
kxam	keskpunkt, keskmine	n.
kxamtseng	kese, koht keskel	n.
kxangangang	pauhh, põmm (kõlamaaling)	intj.
kxanì	keelatud	adj.
kxawm	ehk, võibolla	adv.
kxener	suits	n.
kxetse	saba	n.
kxeyey	viga, eksitus	n.
kxll	kallaletung, rünnak	n.
lahe	teine, teistsugune	adj.
lam	tunduma, paistma	vin.
lapo	teine (isik või asi)	pn.
latem	muutma	vin.
law	kindel, selge	adj.
lefpom	õnnelik, tore, rahulik, hea (elutu kohta)	adj.
lertu	töökaaslane	n.
letrr	(iga)päevane	adj.
letsunslu	võimalik	adj.
lì'u	sõna	n.
lì'fya	keel (suhtlusvahend)	n.
lok	lähenema	vtr.
lonu	vabastama, lahti laskma	vtr.
lor	ilus, meeli rahustav (elutu kohta)	adj.
loreyu	Iluspiraal (helicoradian)	n.
lrrtok	naeratus	n.
lrrtok si	naeratama	vin.
lu	olema (öeldistäide)	vin., svin.
lun	põhjus	n.
lumpe	miks	inter.
ma	oo (üte, kellegi poole pöördumisel)	part.
makto	ratsutama, lendama (loomaga), sõitma	vtr.
mawey	rahulik	adj.
mefo	nemad, need kaks	pn.
menari	silmad (kaks)	n.
meoauniaea	harmoonia, loodusega ühes elamine	n.
meuia	au, austus	n.
meyp	nõrk	adj.
mi	ikka veel, praegugi, nagu enne	adv.
mip	uus	adj.
mikyun	kõrv	n.
mì	sees, peal	adp.
mìn	pöörlema (ümber telje)  Mìn ne ftärpa Keera vasakule	vin.
mìso	eemal (asukoht)	adv.
mllte	nõustuma, leppima	vin.
moe	meie kaks (välistav)	pn.
mokri	hääl	n.
muiä	õige, õiglane, õigustatud	adj.
mun'i	lõikama, raiuma	v.
mune	kaks	num.
munge	võtma, tooma	vtr.
mungwrr	välja arvatud	adp.
muntxa	(kellegagi)paari pandud, ühinenud	adj.
na	nagu	adp.
na'rìng	mets	n.
Na'vi	Rahvas, Pandora põlisasukad	prop.n.
nang	üllatus, vaimustus, ergutushüüd	part.
nantang	soomushunt (viperwolf)	n.
nari	silm	n.
nari si	ette vaatama, ettevaatlik olema	vin.
nawm	üllas, suur	adj.
ne	eessõna (edasi (suund))	adp.
ne'ìm	tagasi (suund)	adv.
nekx	põletama, tarbima	vtr.
neto	eemale (suund)	adv.
new	tahtma	vtrm.
niä	haarama, krahmama	vtr.
nì'aw	ainult	adv.
nìawnomum	teadagi, nagu sa tead (tavakõnes)	adv.
nì'awtu	üksi	adv.
nì'awve	esimesena	adv.
nì'it	natuke	adv.
nì'ul	rohkem, enam, veel	adv.
nìayoeng	nagu meie, nagu me teeme (tavakõnes [naj.wEN])	adv.
nìftue	lihtsalt, kergelt	adv.
nìftxavang	kirglikult, püüdlikult, kogu südamest	adv.
nìhawng	liiga, liialt	adv.
nìltsan	hästi	adv.
nìmun	uuesti, veel	adv.
nìn	vaatama (kuhugile)	vtr.
nìngay	tõesti, tõeliselt	adv.
nìtam	piisavalt	adv.
nìteng	ka, nii, samamoodi	adv.
nìtut	pidevalt, vahet pidamata	adv.
nìtxan	palju	adv.
nìwin	kiiresti	adv.
nìwotx	kõik (absoluutselt kõik)	adv.
nulkrr	pikemalt (ainult aeg)	adv.
nulnew	eelistama (e)	vtrm.
nume	õppima, teada saama	vin.
nga	sina	pn.
ngawng	uss	n.
ngay	tõene	adj.
ngenga	sina (austav vorm)	pn.
ngim	pikk (füüsikaline suurus)	adj.
ngop	looma, tekitama	vtr.
ngrr	juur	n.
nguway	soomushundi hõige, ulgumine	n.
oe	mina	pn.
oeng	meie kaks (välistav), sina ja mina	pn.
oeyk	põhjus, alus	n.
ohe	mina (austav vorm)	pn.
olo'	hõim	n.
olo'eyktan	hõimu valitseja	n.
omum	teadma	vtr.
ontu	nina	n.
pähem	saabuma	vin.
pak	laitmiseks	part.
pa'li	Suurhobu (direhorse)	n.
palulukan	surmapanter (thanator)	n.
pam	heli	n.
pamtseo	muusika	n.
pamtseowll	Kassikõrv (cat ear)	n.
pängkxo	suhtlema, vestlema, suhtlust pidama	vin.
pänutìng	lubama (midagi kellelegi) (e)	vtr.
pätsì	märk, rinnamärk	n.
pawm	küsima	v.
pay	vesi, vedelik	n.
paywll	Veetaim (dapophet)	n.
pe	küsimuse märkija	affix
pe'un	otsustama	vtr.
pefya	kuidas	inter.
pehem	mis (tegevus)	inter.
pehrr	millal	inter.
pelun	miks	inter.
peng	ütlema	vtr.
penghrrap	Narmaslamp (binary sunshine)	n.
peseng	kus	inter.
pesu	kes	inter.
peu	mis (asi)	inter.
pey	ootama	vin.
pizayu	esivanem	n.
plltxe	rääkima	v.
po	tema	pn.
poan	tema (meessoost) (mitmus puudub: kasutada (ay)fo)	pn.
poe	tema (naissoost) (mitmus puudub: kasutada (ay)fo)	pn.
pongu	grupp, hulk (inimeste kohta)	n.
prrnen	beebi, väike laps	n.
prrnesyul	pung	n.
prrte'	nauditav, meeldiv (tegevuse kohta)	adj.
pxan	vääriline	adj.
pxasìk	Käigu kuradile!	intj.
pxasul	värske (toit)	adj.
pxay	palju	adj.
pxey	kolm	num.
pxi	terav	adj.
pxìm	tihti, tihedalt	adv.
pxiut	Teravpuu (razor palm)	n.
pxorna'	Pauktorn (episoth)	n.
pxun	käsi, käsivars	n.
pxuntil	küünarnukk	n.
rä'ä	ära (eitav käsklus)	part.
ral	tähendus	n.
ralpeng	tõlgendama, tõlgitsema (e)	vtr.
rawke	hädakisa, abihüüd	intj.
rel	pilt	n.
reltseo	kujutav kunst	n.
reltseotu	kunstnik	n.
renu	muster	n.
rey	elama	vin.
rikx	liikuma, kohta vahetma	vin.
rim	kollane	adj.
rina'	seeme	n.
riti	Nõelkull (stingbat)	n.
rol	laulma (r«eyk»ol muusikat tegema, laulma panema (lüüriline))	v.
ronsem	mõistus	n.
rum	pall	n.
rumut	Pallpuu (ball tree)	n.
run	leidma, avastama	vtr.
rutxe	palun	intj.
sa'nok	ema	n.
sa'nu	emme (affectionate form of)	n.
san	otsekõne algus	adv.
sänume	õpetus, juhis	n.
säspxin	haigus	n.
sempu	issi (affectionate form of)	n.
sempul	isa	n.
set	nüüd, kohe	adv.
sevin	ilus (naiste kohta)	adj.
seyri	huul	n.
seze	sinine lilll (blue flower)	n.
si	tegema (midagi) (saab olla vaid koos teise sõnaga)	
sì	ja (connects two things, can be attached as --sÃ¬: for clauses use)	conj.
sìk	otsekõne lõpp	adv.
sìlpey	lootma (koos sõnaga tsnì, märkimaks mida loodetakse, kui ta pole just eraldi osalauses) (e)	vin.
sìlronsem	arukas, tark (asi)	adj.
sìltsan	hea	adj.
ska'a	hävitama	vtr.
skxawng	loll, idioot	n.
slä	aga	conj.
slu	saama (kellekski, millekski) (kahemõttelistel juhtudel kasutatakse saavaks käändeks abisõna ne	vin.
sngä'i	algama	vim.
sngä'ikrr	algus	n.
sngel	prügi, saast	n.
sngeltseng	prügila	n.
snumìna	tuhm, tuim (inimese kohta)	adj.
som	kuum, palav	adj.
somtìlor	Triipmuna (popsicle)	n.
spaw	uskuma, tõeks pidama	vtr.
spxam	seen	n.
spe'e	vangistama, tabama	vtr.
spe'etu	vangistatu, kinnipeetu	n.
spxin	haige	adj.
srak	märgib kas...? küsimusi	part.
srake	märgib kas...? küsimusi	part.
srane	jah	part., intj.
srew	tantsima	vin.
srung	abi, toetus	n.
stawm	kuulma	vtr.
steftxaw	uurima, vaatama	vtr.
stum	peaaegu	adv.
sutx	järgnema	vtr.
swaw	hetk, moment	n.
swey	parim	adj.
swirä	elukas, olevus	n.
swizaw	nool	n.
swok	püha	adj.
swotu	püha koht	n.
syaw	kutsuma	vin.
syulang	lill	n.
ta	seestütlev kääne, alates (aeg)	adp.
ta'em	ülevalt, ülalt	adv.
tafral	seetõttu, selle pärast	adv.
täftxu	kuduma	vtr.
täftxuyu	kangur	n.
takuk	lööma, äsama, peale tungima	vtr.
talioang	Sarvpiison	n.
talun	sellepärast (põhjus)	conj.
taluna	sellepärast (põhjus)	conj.
tam	piisama, olgu, okei	vin., intj.
tam tam	rahu, pole hullu	intj.
tangek	puutüvi	n.
tanhì	täht, helendav tähn  ka Na'videl olevad helendavad tedretäed	n.
taron	jahtima	vtr.
taronyu	kütt	n.
tautral	Õõtspalm (sky tree)	n.
taw	taevas	n.
taweyk	sellepärast (põhjendus)	conj.
taweyka	sellepärast (põhjendus)	conj.
tawsìp	taevalaev	n.
tawng	sukelduma	vin.
tawtsngal	Taevaketas (panopyra)	n.
Tawtute	Taevaisik, inimene	prop.n.
te	kasutatakse täisnimedes	part.
tel	kätte saama, vastu võtma	vtr.
telem	nöör, pael	n.
teng	samasugune, võrdne	adj.
tengfya	nii, nagu; sama moodi (situatsiooni saransus)	conj.
tengkrr	samal ajal	conj.
teri	(millegi, kellegi) suhtes	adp.
terkup	surema	vin.
teswotìng	rahuldama (soovi), (lahkelt) andma (e)	vtr.
teya	täis	adj.
teylu	Teilu (beetle larva)	n.
tewti	Ohsaa! väljendab üllatust või rahulolu	intj.
til	hing, ühenduskoht	n.
tirea	vaim, hing	n.
tireafya'o	vaimu/hinge tee	n.
tireaioang	hingeloom	n.
tireapängkxo	lähedaselt suhtlema	v.
tì'eyng	vastus	n.
tìfmetok	kontroll, katse	n.
tìftang	peatumine, kõrisulghäälik	n.
tìfyawìntxu	juhendus, juhatamine	n.
tìhawnu	kaitse	n.
tìkangkem	töö	n.
tìkawng	kurjus, õelus	n.
tìkenong	näide	n.
tìkin	vajadus	n.
tìlor	ilu, kaunidus	n.
tìng	andma	vtr.
tìng mikyun	kuulama	vin.
tìng nari	vaata	vin.
tìngay	tõde	n.
tìpawm	küsimus	n.
tìran	käima, jalutama	vin.
tìyawn	armastus	n.
tìrey	elu	n.
tìrol	laul (vokaalne)	n.
tìspxin	haigus, haigeolek	n.
tìtxur	tugevus, jõud	n.
to	võrdlemise märkija kui 	part.
tok	olema, kohta hõivama	vtr.
toktor	arst	n.
tokx	keha	n.
tompa	vihm	n.
toruk	Suur lendlõvi, Viimane vari (great leonopteryx)	n.
toruk makto	Torukiga lendaja	n.
torukspxam	Hiidseen (octoshroom)	n.
trr	päev	n.
trram	eile	adv.
tukru	oda	n.
tul	jooksma	vin.
tung	lubama, võimaldama	vtr.
tupe	kes	inter.
tut	vestluse jätkamise märkija	part.
tute	isik	n.
tuté	naine (isik)	n.
tutan	mees	n.
tsa'u	see (asi)	dem.
tsaheylu	side	n.
tsakem	see (tegevus)	dem.
tsakrr	siis, sel ajal	adv.
tsam	sõda	n.
tsampongu	sõjakamp	n.
tsamsiyu	sõdalane	n.
tsap'alute	vabandus	n.
tsatseng	seal, selles kohas, see koht	dem., n.
tsatu	see (isik)	dem.
tsawke	päike	n.
tsawl	suur, pikk (inimeste kohta)	adj.
tsawlapxangrr	Tüvipuu (unidelta tree) 	n.
tse'a	nägema (otseselt)	vtr.
tseng	koht	n.
tsenge	koht	n.
tsengpe	kus	inter.
tseo	kunst	n.
tskalep	amb	n.
tsko	vibu	n.
tsko swizaw	vibu ja nool	n.
tskxe	kivi	n.
tskxekeng	treening, harjutus	n.
tslam	aru saama, mõistma	vtr.
tsleng	vale	adj.
tslolam	sain aru! arusaadav	intj.
tsmuk	veresugulane, vend või õde	n.
tsmuktu	veresugulane, vend või õde	n.
tsmukan	vend	n.
tsmuke	õde	n.
tsnì	et,see	sbd.
tsngal	tass, kruus	n.
tspang	tapma	vtr.
tsranten	tähtis olema, lugema	vin.
tstew	vapper (inimeste kohta)	adj.
tstxo	nimi	n.
tsun	võima, suutma	vim.
tswayon	lendama	vin.
tsyal	tiib	n.
tsyo	jahu	n.
tsyorina'wll	Seemnepuu (cycad)	n.
txan	palju, suur hulk (koguse kohta)	adj.
txantsan	oivaline, suurepärane	adj.
txantslusam	tark	adj.
txe'lan	süda	n.
txele	teema	n.
txen	ärkvel, virge	adj.
txep	tuli	n.
txewk	kaigas	n.
txey	peatama, kinni pidama	v.
txìm	tagumik, tagumine ots	n.
txìng	jätma, hülgama	vtr.
txll'u	Torukõrvits (hookagourd)	n.
txo	kui, juhul kui, kas	conj.
txoa	andestus	n.
txokefyaw	teisiti, teistviisi	conj.
txon	öö	n.
txopu	hirm	n.
txula	ehitama, rajama	vtr.
txum	mürk	n.
txumpaywll	Mürknõel (scorpion thistle)	n.
txumtsä'wll	Mürgisarv (Baja tickler)	n.
txur	tugev (füüsiliselt)	adj.
ulte	ja (erinevate lauseosade vahel)	conj.
ultxa	koosolek, kokkutulek	n.
unil	uni	n.
uniltìrantokx	Avatar, uneskäiv keha	n.
uniltìranyu	uneskäija	n.
utral	puu	n.
uvan	mäng	n.
uvan si	mängima (mängu)	vin.
vay	kuni	adp.
virä	levima, vohama	v.
vrrtep	deemon	n.
vul	(puu) haru	n.
way	laul (vana, tseremoniaalne)	n.
waytelem	akord	n.
win	kiire	adj.
wìntxu	näitama	vtr.
'ewll	taim	n.
wrrpa	õu, väljas, õues	n., adv.
wutso	õhtusöök, serveeritud söök	n.
ya	õhk	n.
yawne	armastatud	adj.
ye'rìn	kohe, varsti	adv.
yerik	Sinihirv (hexapede)	n.
yey	sirge	adj.
yìm	siduma	vtr.
yol	lühike (aeg)	adj.
yom	sööma	vtr.
yomhì'ang	Suur kanntaim (dakteron)	n.
yomioang	Surmakarikas (chalice plant)	n.
yomtìng	toitma (sihittis datiivsena) (e)	vin.
yur	pesema	vtr.
za'ärìp	tõmbama	vtr.
za'u	tulema	vin.
zamunge	tooma	vtr.
zawng	karjuma	vin.
zekwä	sõrm	n.
zene	pidama (tegema) Näide Oe zene kivä Ma pean minema	vim.
zìsìt	aasta	n.
zong	päästma, kaitsma	vtr.
zongtseng	varjupaik, pagu	n.
zoplo	solvang	n.
zusawkrr	tulevik	n.
Jakesully	lollakas, Toruk maktoyu	n.
'ärìp	liigutama (midagi)	vtr.
'awstengyem	liitma (kaks asja kokku) (e)	vtr.
'efu	tunnetama, tundma, tajuma	vtr.
'em	kokkama, küpsetama, süüa valmistama	vtr.
'eyng	vastama	v.
'i'a	lõpetama, lõppema	vin.
'ia	ennast kaotama (vaimselt)	vin.
fkxake	sügelema	v.
fmal	ülal hoidma, ülal pidama	vtr.
frìp	hammustama	vtr.
ftem	mööduma	vtr.
fwew	otsima, tuhnima	vtr.
hangham	naerma	vin.
vaykrr	kuni, seni kuni	conj.
sngap	nõelama, torkama	vtr.
hawl	(ette) valmistama	vtr.
kä'ärìp	lükkama	vtr.
kavuk si	reetma	vin.
kllkä	laskuma	vin.
latsi	sammu pidama (kellegagi)	v.
lek	kuuletuma, kuulda võtma	vtr.
len	juhtuma, aset leidma	vin.
lew si	varjama, katma	vin.
muntxa si	üheks saama, paarima (kellegagi), abielluma	vin.
näk	jooma	vtr.
nong	järgnema, järel käima	vtr.
oeyktìng	selgitama, seletama (e)	vtr.
pate	kohale saabuma	v.
piak si	avama	vin.
pom	suudlema, musitama	vtr.
pxor	plahvatama, lõhkema	vin.
salew	edasi minema	v.
sar	kasutama	vtr.
sim	lähedal olema	svin.
sleyku	looma, tekitama	vtr.
sop	reisima, rändama	vin.
spä	hüppama	v.
speng	taastama	vtr.
spule	edasi ajama, lükkama	vtr.
srese'a	ennustama	vtr.
steyki	(kedagi) vihastama	vtr.
sti	vihastuma (sihitu), vihane olema	vin.
sto	keelduma (midagi tegema)	vtrm.
sung	lisama	vtr.
syep	lõksu püüdma, lõksu seadma	vtr.
tatep	tähelepanu kaotama, mõtet kaotama	vtr.
tätxaw	naasma, tagasi tulema	vin.
tem	laskma	vin.
tì'awm si	telkima, matkama	vin.
tì'awm	telkimine	n.
tìkangkem si	töötama	vin.
tìng tseng	tagasi astuma, eest ära tulema	vin.
tìsraw seyki	(kellelgi, millelegi) haiget tegema	vtr.
tìsraw	valu	n.
tìsraw si	valutama, valu tegema	vin.
toltem	(vibu) laskma	vtr.
tsä'	pritsima	v.
tsaheyl si	sidet looma (kellegagi), ühenduma	vin.
tsap'alute si	vabandama	vin.
tsawl slu	kasvama	vin.
tsngawvìk	nutma	vin.
tsre'i	viskama	vtr.
tstu si	sulgema	vin.
tsunslu	võimalik olema	vin.
tsurokx	puhkama	vin.
tungzup	pillama, kukutama	vtr.
wem	võitlema, kaklema	vin.
win säpi	kiirustama	vin.
win si	midagi kiirelt tegema, kiirustama	vin.
yän	kinni siduma	vtr.
yem	panema, asetama	vtr.
zenke	mitte tohtima (e)	vim.
zup	kukkuma	vin.
nekll	alla (suund)	adv.
srung si	aitama, toetama	vin.
txopu si	kartma	vin.
fkip	üleval (millegi) hulgas	adp.
io	ülal, üle	adp.
kxamlä	Läbi (millegi)	adp.
lok	lähedal (millelegi)	adp.
maw	pärast (aeg)	adp.
mìkam	(millegi) vahel	adp.
nemfa	kuhugi sisse	adp.
pxaw	ümber, umbes	adp.
pxel	nii, nagu	adp.
sìn	peal, peale	adp.
takip	hulgast	adp.
uo	taga	adp.
luke	ilma	adp.
tafkip	ülalt (millegi) hulgast	adp.
ro	kohakääne	adp.
sre	enne (aeg)	adp.
wä	vastu (kellegi vastu võitlema)	adp.
fäpa	peal	n.
alìm	kaugel, kaugustes	adv.
aylaru	teistele (lühenenud aylaherust)	pn.
kxu	viga, paha, häda	n.
eltu lefngap	arvuti	n.
kì'ong	aeglane	adj.
säfpìl	idee	n.
kefyak	kas pole nii? eksju?	part.
prrwll	sammal	n.
pängkxoyu lekoren	advokaat	n.
pamrel	kirjutamine, kirjutis	n.
pamrel si	kirjutama	vin.
furia	see, mis	pn., sbd.
fratseng	igal pool	adv.
fratrr	päeviti, iga päev	adv.
frato	ülivõrre, kui kõik	part.
trray	homme	adv.
kea	ei (nimisõnade ees)	adj.
ngian	siiski	adv.
skepek	ametlik	adj.
hufwa	kuigi	conj.
tup	pigem, ennem	conj.
'uo	miski, mingi asi	pn.
tuteo	keegi	pn.
tsengo	kusagil, kuskil kohas	pn.
holpxaype	kui mitu	inter.
hìm	vähe (kogus)	adj.
hìmtxampe	kui palju	inter.
hìmtxan	hulk, kogus	n.
pìmtxan	kui palju, (kui suur kogus/hulk)	inter.
lì'upe	mis (sõna, väljend)	inter.
pelì'u	mis (sõna, väljend)	inter.
ultxarun	kohtama, kokku saama (tahtmatult) (e)	vtr.
ultxa si	kokku saama sihilikult ( hu)	vin.
rangal	soovima	vin.
nìrangal	soov (fakti vastand, koos perfektiivse või imperfektiivse tingiva kõneviisiga)	adv.
txepvi	säde	n.
nitram	rõõmus (inimeste kohta)	adj.
fewi	taga ajama	vtr.
stä'nì	kinni püüdma	vtr.
sran	jah, jaa (kõnekeelne)	part., intj.
weyn	joonistama	vtr.
fìtrr	täna	adv.
rusey	elus, eluline	adj., n.
vitra	hing	n.
nìzawnong	turvaliselt, kindlalt	adv.
ftawnemkrr	minevik	n.
txal	selg	n.
tsìng	neli	num.
mrr	viis	num.
pukap	kuus	num.
kinä	seitse	num.
vol	kaheksa	num.
zam	kuuskümmend neli	num.
tìoeyktìng	seletus	n.
lesar	kasulik (millekski)	adj.
tse	noh (vestluse alustamiseks)	part.
skxom	võimalus, juhus	n.
fkxen	köögivili (toit)	n.
syä'ä	kibe, mõru	adj.
yemfpay si	vedelikku kastma	vin.
yemfpay	sissekastmine (vedelikku)	n.
keng	isegi	adv.
'awlo	ükskord, kunagi	adv.
melo	kaks korda	adv.
heyn	istuma	vin.
nìpxim	sirgelt, korralikult	adv.
pxim	püstine	adj.
tuvon	nõjatuma, toetuma	v.
nìfya'o	(mingil) viisi lNäide: Po poltxe nìfya’o alaw.  Ta rääkis selgelt (ta rääkis selgel viisil)	adv.
letrrtrr	tavaline, harilik	adj.
nì'eoio	pidulikult	adv.
'eoio	pidulik	adj.
rìk	leht	n.
lerìk	lehine, leherikas	adj.
pa'o	pool, külg	n.
kllpa	põhjas, all	n.
mìfa	(millegi) sees	n., adv.
nefä	üles (suund)	adv.
zapxì	eesmine (osa)	n.
käpxì	tagumine osa	n.
käsatseng	seal väljas	adv.
ftxey	kas....või mitte	conj.
ngaytxoa	anna andeks!, vabandust! (süü tunnistamine ja kahetsemine)	intj.
flew	kõri, kurk	n.
kxa	suu	n.
nikre	juuksed	n.
pewn	kael	n.
re'o	pea	n.
sre'	hammas	n.
tsuksìm	lõug	n.
key	nägu	n.
puk	raamat	n.
ngäng	kõht	n.
ta'leng	nahk	n.
tsyokx	käsi	n.
reypay	veri	n.
tsopì	kops	n.
venu	jalg	n.
venzek	varvas	n.
ramunong	kaev	n.
payfya	oja	n.
pxawpa	piir, piirjoon	n.
txampay	meri, ookean	n.
'ora	järv	n.
ekxan	tõke, takistus	n.
tsim	allikas	n.
tsray	küla	n.
txayo	väli, maaala	n.
ukxo	kuiv	adj.
wew	külm	adj.
fìtxon	täna õhtul, tänane õhtu	adv., n.
txonam	eile õhtul, eelmisel õhtul	adv.
txonay	homme õhtul	adv.
sekrr	olevik, praegune hetk	n.
vur	jutt, lugu	n.
tìpängkxo	vestlus, arutlus	n.
tìsrese'a	ennustus	n.
nawmtu	hea/suur inimene	n.
txantstew	kangelane	n.
syuve	toit, söök (mitmus puudub)	n.
tsngan	liha	n.
tstal	nuga	n.
tete	nüri (näiteks noatera)	adj.
lew	kate	n.
'opin	värv	n.
leNa'vi	na'vine, seotud na'videga	adj.
nìNa'vi	nagu na'vid, na'viselt	adv.
hapxìtu	liige	n.
'Rrta	Maa	prop.n.
fwäkìwll	Palveritsika orhidee (mantis orchid)	n.
hì'ang	putukas	n.
payoang	kala	n.
yayo	lind	n.
zize'	Tuliherilane (hellfire wasp)	n.
kemlì'u	tegusõna	n.
tstxolì'u	nimisõna	n.
ftär	vasak (mitte parem)	adj.
skien	parem (mitte vasak)	adj.
'änsyem	täielik	adj.
wotx	täielikkus, kõiksus	n.
mowan	nauditav, rahuldav (füüsiliselt, seksuaalselt)	adj.
vä'	ebameeldiv, vastik	adj.
tatlam	silmnähtavalt, ilmselt	adv.
keteng	teistsugune, teine	adj.
numtseng	kool	n.
skxakep	tõenäoline; tõenäoliselt	adj., adv.
tìprrte'	nauding, rahuldus	n.
kaw'it	üldse, mitte üldse (vaata ke...kaw'it mitte...üldse)	adv.
nìlkeftang	pidevalt, peatumata	adv.
tì'i'avay	lõpuni	adv.
'awm	laager	n.
tìska'a	hävitus, hävitustöö	n.
tìsop	teekond, rännak	n.
wempongu	sõdurite salk, võitlusrühm	n.
asim	läheduses	adv.
klltseng	asukoht	n.
kxutu	vaenlane	n.
mekre	varud	n.
tìhawl	ettevalmistus, plaan	n.
tìkan	siht, eesmärk	n.
tìpähem	saabumine	n.
numeyu	õpilane	n.
soaia	perekond (erp omastava vorm soaiä	n.
tìmuntxa	paarimine, abielu	n.
yawnetu	armastatu	n.
yawntu	armastatu	n.
kakrel	pime Näide:  Pime inimene	adj.
kanu	tark, arukas (inimene)	adj.
koak	vana, eakas (elusolendite kohta)	adj.
lekye'ung	meeletu, hull	adj.
me'em	harmooniline	adj.
txanew	ahne	adj.
txantur	võimas, võimukas	adj.
tì'awpo	individuaalsus (negatiivse varjundiga), isekus	n.
tì'eylan	sõprus	n.
fkay	vihkav, viha täis	adj.
keltsun	võimatu	adj.
kxuke	turvaline	adj.
lehawng	liigne, ülemäärane	adj.
hawng	liigne, ülemäärane	n.
lekin	vajalik	adj.
stxong	imelik, tundmatu	adj.
syen	viimane, lõplik	adj.
kavuk	reetmine, äraandlikkus	n.
fpìlfya	mõtteviis	n.
syay	saatus	n.
tìfnu	vaikus	n.
tìngop	loomine	n.
tìpe'un	otsus	n.
kxitx	surm	n.
trr'awve	pühapäev	n.
trrmuve	esmaspäev	n.
trrpxeyve	teisipäev	n.
trrtsìve	kolmapäev	n.
trrmrrve	neljapäev	n.
trrpuve	reede	n.
trrkive	laupäev	n.
'ango	mahe, tasane (heli kohta)	adj.
kxayl	kõrge	adj.
rey'eng	Elu Tasakaal	n.
tìme'em	harmoonia (üldiselt)	n.
fnel	liik, sort, laad	n.
fnepe	missugune? (mis liiki?  sorti? jne)	inter.
pefnel	missugune (mis liiki?  sorti? jne)	inter.
zerok	mäletama, meeles midama	vtr.
tswa'	unustama	vtr.
tì'efu	tunne	n.
maweypey	kannatlik olema (e)	svin.
tìmweypey	kannatlikkus	n.
lemweypey	kannatlik	adj.
nìmweypey	kannatlikult	adv.
tsakrrvay	sel ajal, niikaua	adv.
ohakx	näljane	adj.
tìohakx	nälg	n.
tsyosyu	jahust tehtud toit	n.
vey	liha, loomalihast toit	n.
trrpeve	mis päeval? (tuletatud sõnast päev ja liidetest pe küsisõna märkija ja ve järgarvsõna märkija)	inter.
pxiswawam	just hetk tagasi	adv.
pxiset	nüüd kohe	adv.
pxiswaway	kohe hetke pärast	adv.
pxiye'rìn	otsekohe (mitte nii ruttu nagu pxisaway)	adv.
pxisre	just enne	adp.
pximaw	kohe pärast	adp.
sok	hiljutine	adj.
'awlie	kunagi, ükskord (minevikus)	adv.
tìkxey	vigasus, ebakorrektsus	n.
tìkxey si	valesti tegema, ära rikkuma	vin.
tìyawr	õigsus, veatus	n.
tìketeng	erinevus, teistsugusus	n.
fpomtokx	tervis (füüsiline)	n.
lefpomtokx	tervislik (füüsiliselt)	adj.
kelfpomtokx	ebatervislik (füüsiliselt)	adj.
keftxo	õnnetu, 'Kui kurb!'	adj., intj.
nìkeftxo	kahjuks, õnnetuseks	adv.
sraw	valus	adj.
txampxì	enamus, suur osa	n.
vurvi	kokkuvõte	n.
sänumvi	õppetund	n.
letam	piisav	adj.
letsranten	tähtis	adj.
nìswey	kõige paremini	adv.
nìpxi	ühemõtteliselt, suunatud just (kellelgi/millelegi)	adv.
wok	vali, häälekas	adj.
spuwin	vana, eelnev (elutu kohta)	adj.
nì'eyng	tagasi (saabunud)	adv.
nìkanu	targalt	adv.
nìlaw	selgelt, kindlalt	adv.
tìsti	viha	n.
tìtxanew	ahnus	n.
tìftxey	valik	n.
tìkanu	tarkus	n.
tìlam	välimus, esinemine, nähtumine	n.
tìtslam	arusaamine, tarkus	n.
tìtxula	konstrueerimine, ehitis	n.
hewne	pehme (asi)	adj.
tìm	madal	adj.
laro	puhas	adj.
tsewtx	must, räpane	adj.
lefngap	metalne	adj.
txa'	kõva	adj.
fwel	katkine	adj.
etrìp	soodustav, heaendeleine, paljutõotav	adj.
piak	lahtine; selge (ilm)	adj.
tstu	kinnine, suletud; pilves (ilm)	adj.
kxll si	ründama	vin.
tsaw	see (sama nagu tsa'u	dem., pn.
tsalsungay	siiski, sellest hoolimata	adv.
oìsss	vihane lõrisemine 'vaata ette!'	intj.
saa	ähvardav hõige	intj.
sau	pingutuse väljendamiseks ('mmh', 'pff', 'uhh')	intj.
tsahey	hoiatuse või viha väljendus ('jama!', 'põrgusse!')	intj.
wiya	hoiatuse või viha väljendus ('kurat!')	intj.
ìley	sõjahüüd	intj.
vawm	tume, pime	adj.
tìvawm	pimedus	n.
polpxay	kui mitu	inter.
ke'aw	eraldatud, lahku löödud	adj.
nìsti	vihaselt	adv.
teyr	valge (värv)	adj.
layon	must (värv)	adj.
pänu	lubadus	n.
kew	null, sümbol 0	num.
'eyt	sümbol 8 (mitte väärtus)	n.
nayn	sümbol 9 (mitte väärtus)	n.
trr'ong	koit, päiksetõus	n.
trr'ongmaw	päiksetõusujärgne koit	n.
rewon	hommik	n.
srekamtrr	aeg enne lõunat	n.
kxamtrr	keskpäev, lõuna	n.
kxamtrrmaw	aeg kohe pärast lõunat, varajane pärastlõuna	n.
ha'ngir	pärastlõuna	n.
kaym	õhtu (enne videvikku), hiline pärastlõuna	n.
sreton'ong	aeg enne päikseloojangut	n.
txon'ong	videvik, päikeseloojang, koidukuma	n.
txon'ongmaw	aeg pärast videvikku, enne pimedaks minemist	n.
srekamtxon	aeg enne keskööd	n.
kxamtxon	kesköö	n.
kxamtxomaw	aeg pärast keskööd	n.
sresrr'ong	aeg enne koitu	n.
wou	olema äge, kift (släng)	svin.
tsyìräfì	Kaelkirjak	n.
tsawa	see, mis	pn., sbd.
tsata	seda, mis	pn., sbd.
tsaria	see, mis	pn., sbd.
alo	kord (Näiteks kolm korda)	n.
fralo	iga kord, igal juhul	adv.
nìmwey	rahulikult	adv.
ku'up	raske (füüsiline mass)	adj.
syo	kerge (füüsiline mass)	adj.
hay	järgmine	adj.
ham	eelmine	adj.
matsa	kuivik	n.
hametsì	juuretis	n.
tìkangkemvi	projekt, töö osa	n.
nì'i'a	lõpuks	adv.
nìsyen	viimaks, viimaseks	adv.
pìlok	blogi	n.
tsulfätu	meister, ekspert (kunsti, käsitöö, oskuse)	n.
tsulfä	meisterlikkus	n.
tsulfä si	omandama (mingit oskust)	vin.
numtsengvi	klassiruum, kooli jaotus	n.
rofa	kõrval, naabruses	adp.
pum	omand, omatav asi (kaassõna vastavate nimi ja asesõnade juures)	pn.
Yuesey	USA	prop.n.
teya si	täitma ( asi, mida täidetakse datiivselt)	vin.
alunta	sellepärast (põhjusest)	conj.
nìprrte'	hea meelega, võta heaks, loomulikult, tere tulemast (eeldatava sõnaga zola'u)	adv.
sngä'iyu	algaja, alustaja	n.
srekrr	enne, varem	adv.
ayu	asjad	n.
tsafya	niimoodi, sedamoodi	adv.
muve	teine	adj.
pxeyve	kolmas	adj.
tsìve	neljas	adj.
mrrve	viies	adj.
puve	kuues	adj.
kive	seitsmes	adj.
volve	kaheksas	adj.
tsyänel	Telekanal	n.
trrtxon	ööpäev	n.
au	jahmatuse märkija	intj.
pängkxoyu	vestleja, suhtleja	n.
lekoren	seaduslik	adj.
prrkxentrrkrr	suitsetamise nautimine päevasel ajal (Na'vi idioom)	n.
tìftia	õpe	n.
tìftia kifkeyä	teadus, füüsilise maailma õpe	n.
pxir	õlu	n.
eanean	Sinitaim (cheadle)	n.
'ele'wll	Okaskäpp, kaktus (thorny paw)	n.
tstxa'a	Pikuke (canalyd)	n.
pa'liwll	Hobukann (direhorse pitcher plant)	n.
anìheyu	Sinispiraal (fibonacci)	n.
tompawll	Vihmataim (geode)	n.
pxiwll	Terataim (hermit bud plant)	n.
syeptute	Lõkstaim (hyneman)	n.
kllpxiwll	Lõvimari (lionberry)	n.
smaoe	Okkaline sõdur (phalanxia)	n.
'ä'o	Kannuke (pitcher plant)	n.
mulpxar	Kukepea	n.
flefle	Õnnetaim (Sol's delight)	n.
kxaylte	Küüsleht (cillaphant)	n.
fkxakewll	Pungohakas (itch plant)	n.
tìhawnuwll	Kilptaim (spartan)	n.
pxorna'lor	Ilus paukur	n.
pxayzekwä	Okasnüpits (spiny whips)	n.
mìnyu	Keerdliilia (twisted lily)	n.
mìnyu	keeraja, pööraja	n.
väfewll	Haisik (centipede)	n.
sngukx	Songik (grub plant)	n.
rawp	Põiskaun (bladder)	n.
'ampirikx	Lehekukutaja (leaf pitcher plant)	n.
apxangrr	Hiidpuu (delta tree)	n.
värumut	Haisupunn (vein pod)	n.
keyawr	vale, mitte õige	adj.
lehrrap	ohtlik	adj.
tìtxen	ärkvel olek, ärkamine	n.
hìrumwll	Kuulipuu (puffer plant)	n.
fwäkì	Palveritsikas	n.
fratxon	igal õhtul	adv.
hìkrr	sekund, väga lühike aeg	n.
mawkrr	pärast, hiljem	adv.
ngeyn	väsinud	adj.
ngopyu	looja	n.
nìk'ong	aeglaselt	adv.
pamtseotu	muusik	n.
sat	see	pn.
tsal	see (alus)	pn.
tsat	seda (asja)	pn.
tsawlhì'	suurus	n.
lì'fyavi	väljend, keele osa	n.
nafì'u	selline	adj.
lì'fyaolo'	keelegrupp, keele kasutajad	n.
puktsyìp	raamatuke, buklet	n.
utraltsyìp	põõsas	n.
säspxintsyìp	kerge haigus, põdur olek	n.
'itetsyìp	väike tütreke (õrnusest või armastusest öelduna)	n.
sa'nutsyìp	väike emake (kasutatakse väikeste tüdrukute puhul)	n.
kem si	tegema	vin.
tswin	juuksepats, Na'videl olev närvipats (sideme loomiseks)	n.
tswintsyìp	väike patsike	n.
taronyutsyìp	väike kütt	n.
oetsyìp	pisike mina	pn.
ngatsyìp	väike sina, sa väike	pn.
atanvi	valguskiir	n.
txeptsyìp	väike lõkkeke, armas tuleke	n.
tìkusar	õpetamine	n.
tìyusom	söömine	n.
tìtusaron	jahtimine	n.
tìpängkxotsyìp	väike vestlus, pisike jutuajamine	n.
hayalo	järgmine kord	adv.
hamalo	viimane/eelmine kord	adv.
tstunwi	lahke, hell, hooliv	adj.
seykxel	tugev (emotsionaalselt, vaimselt, mitte füüsiliselt), endas kindel	adj.
fuke	või mitte	conj.
'a'aw	mõni, mõned	adj.
'okrol	ajalugu (vanem)	n.
'okvur	ajalugu (hiljutisem)	n.
alu	mis on, teise sõnaga, teisiti	conj.
fnawe'	argpükslik	adj.
fnawe'tu	argpüks	n.
ftxìlor	maitsev	adj.
ftxìvä'	halvasti maitsev	adj.
fyeyn	küps, valmis, täiskasvanud	adj.
fyeyntu	täiskasvanu	n.
tìfyeyn	küpsus, valmidus, täisealisus	n.
hawngkrr	hilja	adv.
lehawngkrr	hiline	adj.
leye'krr	varajane	adj.
hek	olema huvitav, imelik, kummaline, üllatav	vin.
nìhek	kummaliselt, huvitaval kombel	adv.
ki	pigem, ennem, kui et	conj.
nìfyeyntu	nagu täiskasvanu, küpselt	adv.
nì'eveng	nagu laps, lapsikult	adv.
lìng	(õhus) hõljuma	vin.
ram	mägi	n.
muntxatu	abikaasa	n.
muntxatan	mees (abikaasana)	n.
muntxate	naine (abikaasana)	n.
netrìp	õnnelikult	adv.
newomum	huvi tundma, teada tahtma	svin.
lenomum	uudishimulik	adj.
tìnomum	uudishimu	n.
ngäzìk	raske, raskesti teostatav	adj.
tìngäzìk	raskus, probleem	n.
nìsung	pealegi, lisaks, veelgi enam	adv.
reng	madal	adj.
rolun	Heureka!, Käes!, Üles leidsin!	intj.
sa'sem	vanem või vanemad	n.
smar	saak, jahitud asi	n.
starsìm	korjama, koguma	vtr.
sunu	olema meeldiv, rahuldust pakkuv	vin.
syayvi	õnn, edu, (juhuslik) võimalus	n.
nìsyayvi	juhuslikult	adv.
tolel	Heureka!, Ma saan aru!	intj.
txukx	sügav (füüsiliselt)	adj.
ve'kì	vihkama	vtr.
tìve'kì	viha	n.
yaymak	rumal, võhiklik	adj.
ye'krr	vara	adv.
zìsìkrr	aastaaeg	n.
zo	hästi olema., olema nii, nagu peab., töötama nii, nagu ette nähtud.	svin.
zoslu	paranema, korda saama (e)	vin.
zeyko	ravima, parandama	vtr.
frawzo	kõik on korras, kõik on hästi	intj.
kemlì'uvi	siseliide	n.
irayo si	tänama, tänu andma	vin.
lefkrr	praegune	adj.
lì'upam	aksent, hääldus	n.
natkenong	näiteks, näitena	conj.
eltur tìtxen si	huvitav olema	vin.
pxelo	kolm korda	adv.
pamrelfya	õigekiri (õigesti kirjutamise viis)	n.
law si	selgitama, selgeks tegema	vin.
tìsung	P.S, lisaks veel	n.
naer	jook	n.
atxkxerel	kaart, plaan	n.
nìtengfya	samalaadselt	adv.
tun	punane, oranž	adj.
'om	violetne, lilla	adj.
neyn	hele (värv)	adj.
ngul	hall, hallikas	adj.
tumpin	punane, oranž	n.
eampin	sinine, roheline	n.
rimpin	kollane	n.
'ompin	violetne värv, lilla	n.
layompin	must	n.
teyrpin	valge	n.
vawmpin	tume värv	n.
neympin	hele värv	n.
ngulpin	hall	n.
pil	näojoon, näotriip 	n.
ta'lengean	nahasinine	adj.
rìkean	lehtroheline	adj.
kllvawm	pruun	adj.
'evan	poiss, kutt (kõnekeelne)	n.
'eve	tüdruk (kõnekeelne)	n.
'evengan	poiss	n.
'evenge	tüdruk	n.
fkio	Libliklohe (tetrapteron)	n.
kenten	Tiibsisalik (fan lizard)	n.
nìwä	vastupidi, vastupidiselt	adv.
pìwopx	pilv	n.
ramtsyìp	küngas, väike mägi	n.
syaksyuk	Hiidleemur (prolemuris)	n.
tor	viimane, viimne, lõpetav	adj.
txärem	luu, kont	n.
uk	vari	n.
yapay	udu, aur	n.
tìspe'e	vangistamine, tabamine	n.
tìftxavang	kirg	n.
tìtstunwi	lahkus, heldus	n.
stxeli	kingitus, and	n.
ngrrpongu	rohujuurte liikumine	n.
smon	tundma, teadma ( datiivne kääne)	vin.
lawk	vestlema, rääkima (millestki)	vtr.
hìtxoa	vabandage, vabandust	intj.
mäkxu	segama, rikkuma, häirima	vtr.
hultstxem	takistama	vtr.
mok	soovitama	vtr.
muwìntxu	tutvustama, esitlema	vtr.
kan'ìn	keskenduma (millelegi), spetsialiseeruma, eriliselt huvitatud olema	vtr.
tìwusem	võitlemine	n.
nì'eng	võrdselt, samaväärselt	adv.
Pari	Pariis	prop.n.
tì'ong	õitsemine	n.
tìmok	soovitamine	n.
tì'em	kokkamine	n.
leyn	kordama, uuesti tegema	vtr.
päsketpol	korvpall	n.
nìFranse	prantsuse moodi, prantsuse keeles	adv.
nìToitsye	saksa moodi, saksa keeles	adv.
nìno	detailselt, põhjalikult, läbinisti	adv.
hìno	detailne, täpne (asjade kohta)	adj.
leno	täpne, põhjalik (inimeste kohta)	adj.
tìno	täpsus, põhjalikkus, detailsus	n.
'ongokx	sündima	vin.
nokx	sünnitama	vtr.
nìtrrtrr	(iga)päevaselt, regulaarselt	adv.
tìn	hõivatus; hõivav tegevus	n.
txin	peamine, põhiline	adj.
txintìn	amet, peamine roll ühiskonnas	n.
'emyu	kokk, söögi tegija	n.
vewng	hoolitsema, vastutama (millegi/kellegi eest)	vtr.
kaltxì si	tervitama, tere ütlema	vin.
sopyu	rändaja, reisija	n.
fula	see, mis	pn., sbd.
tskxekeng si	harjutama, treenima	vin.
way si	laulma	vin.
swawtsyìp	lühike hetk, sekund	n.
käteng	aega veetma, koos olema	vin.
'ìn	hõivatud olema	svin.
Sweriye	Rootsi	prop.n.
nìfkrr	hiljuti	adv.
sulìn	hõivatud olema (heas mõttes); olema keskendunud millelegi, mis on rahustav ja huvi pakkuv	svin.
vrrìn	hõivatud olema (halvas mõttes); olema väsinud ja küllastunud mingist hõivavast tegevusest	svin.
tìk'ìn	vaba aeg, hõivatuse puudumine	n.
säsulìn	hobi, meelerahu pakkuv tegevus	n.
'o'	lõbu pakkuv, põnev, erutav	adj.
Europa	Euroopa	prop.n.
skxaypxe	Skype	n.
pxorpam	rõhuga kaashäälik	n.
tì'o'	lõbu, erutus	n.
nì'o'	nauditaval, lõbusal viisil	adv.
fnan	hea olema (milleski)	vtr.
wätx	halb olema (milleski)	vtr.
tìsom	kuumus	n.
tìwew	külm	n.
tìlen	üritus, juhtum	n.
nìnäk	juues, vedelal viisil	adv.
nìhay	järgmisena	adv.
sayrìp	kena, nägus (meeste kohta)	adj.
letokx	kehane, füüsiline	adj.
säzärìp	Suurhobu ohjad	n.
ìpxa	Sõnajalg	n.
tìhawnu si	kaitsma	vin.
sno	tema/nende enda oma (enesekohane genitiivne vorm: sneyä)	pn.
kìte'e si	teenima	vin.
var	püsima mingis toimingus, jätkama mingit tegevust	vim.
nìftxan	ühtmoodi, samal hulgal	adv.
Yeysu	Jeesus	prop.n.
lelì'fya	keelealane	adj.
takrra	alates, juba	conj.
akrrta	alates, juba	conj.
few	üle, teisele poole	adp.
fewtusok	teisel pool, vastasolev (kõnekeeles: fewtsok (few.tsok))	adj.
sla'tsu	kirjeldama	vtr.
tìsla'tsu	kirjeldus	n.
'en	aimdus, tunnetus	n.
'en si	pakkuma, aimama, arvama	vin.
le'en	vaistlik	adj.
nì'en	vaistu järgi (tegema)	adv.
sä'o	tööriist, nõu	n.
pamtseo si	muusikat tegema (fa (muusikariista) mängima)	vin.
väng	janune	adj.
tìväng	janu	n.
sngum	mure	n.
nìsngum	murelikult	adv.
yayayr	meeltesegadus	n.
wäte	vaidlema	vtr.
tìwäte	vaidlus	n.
säwäte	väide, argument, vaieldav teema	n.
lewäte	vaieldav	adj.
nìwäte	vaieldavalt	adv.
li	juba	adv.
lisre	(mingiks ajaks) teostama	adp.
ronsrelngop	kujutle, kujuta ette  (tuletatud sõnadest ronsem mõistus, rel pilt, ngop clooma, kõnekeelselt [Ron.sREw.Nop] 	vtr.
ronsrel	kujuteldav asi	n.
tìronsrel	kujutlus	n.
txanatan	hele, ere	adj.
leronsrel	kujuteldav	adj.
nìronsrel	ette kujutades	adv.
srefey	ootama, lootma (millegi tulekule)	vtr., vin.
mawl	pool (millestki)	n.
pan	kolmandik, üks kolmandik	n.
wan	peitma	vtr.
nìwan	salaja, varjavalt	adv.
tìwan	segaseks tegemine, varjamine	n.
letwan	kaval, hiiliv (inimese kohta)	adj.
slele	ujuma	vin.
nìslele	ujudes, ujuvalt	adv.
tìtaron	jahtimine	n.
ìì	ee, õõ, ää, hmm	intj.
tsukyom	söödav	adj.
ketsuktswa'	unustamatu	adj.
tsuktswa'	unustatav	adj.
yafkeyk	ilm	n.
fkeytok	olema, eksisteerima	vin.
tìfkeytok	olek, konditsioon, olukord	n.
tompameyp	seenekas, hoovihm	n.
tskxaytsyìp	rahe	n.
tskxepay	jää	n.
herwì	lumi	n.
tomperwì	lörts	n.
txanfwerwì	lumetorm	n.
hermeyp	lumesadu	n.
hertxayo	lumeväli	n.
ìlva	tilk, helves, piisk	n.
txepìva	tuhk	n.
herwìva	lumehelves	n.
payìva	veetilk	n.
tompìva	vihmapiisk	n.
kintrr	nädal	n.
mrrtrr	arginädal, töönädal	n.
muntrr	nädalavahetus	n.
kintrram	eelmine nädal	n.
kintrray	järgmine nädal	n.
muntrram	eelmine nädalavahetus	n.
muntrray	järgmine nädalavahetus	n.
vospxì	kuu	n.
vospxìam	eelmine kuu	n.
vospxìay	järgmine kuu	n.
sweylu	peaks (pidama tingiv kv.)	v.
ye	rahul, rahuldatud, täidetud	adj.
hasey si	lõpetama, kokku võtma, ära tegema	vin.
seysonìltsan	Hea töö! (tuletatud fraasist hasey soli nìltsan hästi tehtud)	intj.
yehakx	nälja kustutanud, täis	adj.
yeväng	janu kustutanud	adj.
somwew	temperatuur	n.
pup	lühike (füüsiline)	adj.
ngimpup	pikkus	n.
pesomwew	mis temperatuur on?, kui soe on?	inter.
somwewpe	mis temperatuur on?, kui soe on? (tavapärasem)	inter.
txawew	väga külm	adj.
wur	jahe	adj.
tsyafe	keskmine, tavapärane	adj.
sang	soe	adj.
txasom	väga kuum	adj.
leyapay	udune	adj.
lepwopx	pilvine	adj.
nìhol	vähe	adv.
nìpxay	palju, paljuhulgaliselt	adv.
paynga'	niiske, rõske	adj.
meuianga'	auline	adj.
txumnga'	mürgine	adj.
'akra	pinnas	n.
hufwetsyìp	õrn tuul	n.
nìlam	näivalt	adv.
nìli	ennatlikult	adv.
nìfrakrr	nagu alati	adv.
am'a	kahtus	n.
nga'	sisaldama	vtr.
tìftang si	peatama (kedagi või midagi)	vin.
may'	proovima, hindama, üle vaatama, testima	vtrm.
yora'	võitma	vtr.
snaytx	kaotama	vtr.
tìyora'	võit	n.
tìsnaytx	kaotus	n.
'otxang	muusikariist	n.
skxir	haav, vigastus	n.
leskxir	haavatud, vigastatud	adj.
skxir si	haavama, vigastama	vin.
skxirtsyìp	marrastus, sisselõige, väike haav	n.
sloan	valama, kallama	vtr.
emrey	ellu jääma, üle elama	vin.
temrey	ellujäämine	n.
lemrey	ellujäänud (nt. mingist grupist ellujäänud inimesed)	adj.
nemrey	ellujäävalt (midagi tegema)	adv.,intj.
wawe	tähendus, tähtsus	n.
txanwawe	suur tähtsus, isiklikult tähtis	adj.
nìwawe	tähenduslikult	adv.
keyrel	näoilme	n.
fwampop	tapirus (loom)	n.
säplltxe	teadaanne, väide	n.
säplltxevi	kommentaar	n.
kawtseng	mitte kusagil	adv.
tsapo	see (inimeste kohta)	pn.
fwefwi	vilistama	vin.
'etnaw	õlg	n.
pllngay	möönma, tunnistama	vin.
kawngsar	ära kasutama, halvasti kohtlema	vtr.
lom	igatsetud (kaua ära olnud inimese kohta)	adj.
koaktan	vanamees	n.
koakte	vanamemm	n.
koaktu	vana inimene	n.
lomtu	igatsetud inimene	n.
fe'	halb, paha	adj.
nìfe'	halvasti	adv.
wätu	vastane	n.
fekem	õnnetus	n.
hawtsyìp	uinak	n.
uran	paat	n.
ftxozä si	tähistma	vin.
kekem	mitte midagi (tegude puhul)	pn., adv.
pxen	riietus, riideese	n.
tewng	niudevöö	n.
raspu'	jalakaitsmd (kasutatakse sõjas)	n.
hawnven	jalats	n.
hawntsyokx	kinnas	n.
hawre'	müts	n.
ioi	ehe, kaunistus, tseremooniariietus	n.
nìlun	muidugi, loogiliselt	adv.
'ali'ä	krae	n.
'are	keep	n.
fkxile	kaelakee	n.
masat	rinnarüü (sõjas)	n.
nikroi	juuksekaunistus	n.
pxawpxun	käekaitse	n.
renten	prillid	n.
tsamopin	sõjamaskeering	n.
tsang	läbilõige	n.
miktsang	kõrvarõngas	n.
ontsang	ninarõngas	n.
yemstokx	selga panema (riideid)	vtr.
ioi si	kaunistama, ehtima	vin.
'aku	ära võtma, eemaldama	vtr.
le'aw	ainult	adj.
mawkrra	pärast (mingit asja)	conj.
akrrmaw	pärast	conj.
Toitslan	Saksamaa	prop.n.
Toitsye	Saksa keel	adj.
lukpen	ilma riieteta, paljas	adj.
fmawnta	uudist, mida)	n.
vin	nõudma, küsima, paluma	vtr.
mìftxele	teemasse, selle teemaga seotult	adv.
zìma'uyu	uustulnuk, äsja saabunu	n.
nìvingkap	muuseas	adv.
txankrr	pikka aega	adv.
vingkap	pähe turgatama, mõtesse tulema	vtr.
tìomum	teadmised (ainsus)	n.
tinan	lugemine	n.
ninan	lugemise kaudu, lugedes	adv.
tsmìm	jälg (looma)	n.
inan	lugema (nt. metsa), ammutama teavet	vtr.
'ä'	Ups!	intj.
teynga	vastus, mis 	n.
teyngla	vastus, mis (aluse kääne)	n.
teyngta	vastust, mida	n.
fayluta	neid sõnu, mida	n.
stxenu	and	n.
tìtstew	vaprus, julgus	n.
tìtstewnga'	vapper, julge (elutu kohta, nt. vapper tegu)	adj.
stxenutìng	pakkuma	vtr.
tsyär	tagasi lükkama, ära põlgama	vtr.
tìtsyär	tagasilükkamine, kõrvaleheitmine	n.
mll'an	vastu võtma, aktsepteerima	vtr.
tìmll'an	vastu võtmine, aktsepteerimine	n.
kam	(aastat, kuud vms,) tagasi	adp.
kay	tulevikus (aastat, kuud, vms.)	adp.
'awnìm	vältima	vtr.
steng	sarnane, samasugune	adj.
nìsteng	sarnaselt	adv.
nim	häbelik, arg	adj.
srätx	tüütama, vaevama	vtr.
säsrätx	tüütamine, vaevamine	n.
rì'ìr	peegeldus	n.
rì'ìr si	peegeldama, matkima	vin.
tsìsyì	sosistama	vin.
nìwok	häälekalt, kõvasti	adv.
sätsìsyì	sosin	n.
nìtsìsyì	sosinal, sosistades	adv.
nìfwefwi	vilinal, vilistades	adv.
lawr	meloodia	n.
tìng lawr	ümisema, sõnadeta laulma	vin.
säomum	infokild	n.
kosman	vapustav, tore, vahva, lahe	adj.
nìksman	vapustavalt	adv.
letsim	ainulaadne, originaalne	adj.
lesngä'i	esmane, algusest saati olemasolev	adj.
nìtsim	ainulaadselt, originaalselt	adv.
nìsngä'i	algupäraselt	adv.
ngong	tuim, laisk	adj.
walak	energiline, aktiivne	adj.
tìngong	tuimus, laiskus	n.
txi	kiireloomulisus	n.
letxi	kiireloomuline, rutakas (inimeste kohta)	adj.
nìtxi	kiirelt, rutakalt	adv.
letxiluke	rahulik, aeglane (inimeste kohta)	adj.
nìtxiluke	rahulikult, aeglaselt	adv.
kulat	avaldama, paljastama, ilmvalgele tooma (nii otseselt kui ka metafooriliselt)	vtr.
txantompa	tugev vihm	n.
meyam	kallistama, embama, kaistuama	vtr.
sämyam	kallistus, embus	n.
fìtsap	teineteist	adv.
nuä	taga, kaugemal (nt. Awnga kelku si nuä ayram alusìng  me elame hõljuvate mägede taga/mägedest edasi)	adp.
kanfpìl	keskenduma, tähelepanu koondama	vin.
fmokx	kadedus	n.
nìfmokx	kadedalt	adv.
kìmar	hooajaline	adj.
nìkmar	õigel ajal	adv.
nìngong	tuimalt, laisalt	adv.
säpom	suudlus, musi	n.
kxukx	neelama, neelatama	vtr.
txewm	hirmus, õudne	adj.
hìmpxì	vähemus, väiksem osa	n.
kawnglan	kahjulik, ohtlik, viga tegev, kuri	adj.
nutx	paks	adj.
flì	õhuke, peenike (elutu kohta)	adj.
flìnutx	paksus	n.
sneyä	tema enda oma	pn.
säsyep	lõks	n.
yora'tu	võitja	n.
snaytu	kaotaja	n.
way a plltxe	luuletus e. räägitud laul	ph.
way a rol	lauldud laul	ph.
wayä aylì'u	luuletuse või laulu sõnad	ph.
ultxatu	kohtuja, kohtumises osaleja	n.
wo	upitama, ulatuma	vtr.
yawo	startima, õhku tõusma	vin.
tsìk	järsku,  ilma hoiatuseta	adv.
kllwo	maanduma (protsess)	vin.
kllpä	maanduma, maani jõudma	vin.
sätswayon	lend	n.
rawn	asendama, vahetama	vtr.
tìrawn	asendamine, vahetamine	n.
särawn	asi, mis asendati või vahetati	n.
kxeltek	kätte võtma, tõstma	vtr.
fngo'	nõudma, vajama	vtr.
säfngo'	nõudmine	n.
ngam	kaja	n.
slär	koobas	n.
ngampam	riim	n.
ngampam si	riimuma	vin.
faoi	sile, tasane	adj.
ekxtxu	krobeline	adj.
yo'	ideaalne olema, veatu olema	svin.
nìyo'	ideaalselt, veatult	adv.
nìyol	lühidalt (ajaliselt)	adv.
tìyo'	ideaalsus	n.
'ipu	naljakas, lõbustav	adj.
tì'ipu	huumor	n.
tìfmi	katsetus, proov	n.
sä'ipu	nali	n.
hangvur	nali, naljajutt, andekdoot	n.
lì'uvan	sõnamäng	n.
kanom	saama, omandama	vtr.
säkanom	omandatud asi, omand	n.
srìn	ühelt teisele üle andma (kasutatakse harva eesliideteta)	vtr.
käsrìn	laenuks andma, laenama	vtr.
zasrìn	laenuks võtma, laenama	vtr.
säsrìn	laenatud asi	n.
pxìmun'i	jagama, jaotama, tükkideks lõikama	vtr.
lätxayn	alistama (lagingus), vallutama	vtr.
sälätxayn	kaotus, kui ollakse alistatud	n.
yll	kogukondlik, ühine	adj.
nìyll	ühiselt	adv.
hona	armas, imetlusväärne	adj.
tìhona	imetlusväärsus	n.
fäkä	tõusma, üles minema	vin.
fäza'u	üles tulema, tõusma	vin.
kllza'u	alla tulema, laskuma	vin.
sämok	soovitus, ettepanek	n.
mal	usaldusväärne	adj.
nìmal	usaldavalt, kahtluseta	adv.
tìmal	usaldusväärsus	n.
kllyem	matma	vtr.
nìtsyìl	ronimise abil/kaudu	adv.
sätsyìl	ronimine	n.
rìn	puit	n.
flawkx	nahk (esemetel)	n.
'ana	rippuv marjapõõsas	n.
tsngawpay	pisarad	n.
tsngawpayvi	pisar	n.
nìhona	armsalt	adv.
lepay	vesine	adj.
'ul	suurendama	vin.
nän	vähendama	vin.
nìnän	vähem	adv.
nì'ul'ul	suurenevalt, üha rohkem ja rohkem	adv.
nìnänän	vähenevalt, üha vähem ja vähem	adv.
mek	tühi; metafooriliselt: väärtusetu	adj.
leioae	austus, respekt	n.
leioae si	austama	vin.
säwìntxu	näitus, näitamine	n.
tì'i'a	lõpp	n.
srer	ilmuma, tekkima, vaatevälja tulema	vin.
'ìp	kaduma, haihtuma, vaateväljast lahkuma	vin.
tsong	org	n.
tsongtsyìp	süvend, lohk	n.
ro'a	imetlusväärne olema, vägev olema	vin.
säro'a	saavutus, imetlusväärne tegu	n.
säro'a si	suuri tegusid tegema	vin.
txanro'a	kuulus olema	vin.
velek	alla andma, kaotusega nõustuma	vin.
spono	saar	n.
txew	äär, piir	n.
txewnga'	piire omama, lõplik olema	adj.
litx	terav	adj.
fwem	nüri	adj.
syura	energia (füüsiline või spirituaalne)	n.
syuratan	bioluminestsents, organismide võime toota soojuseta valgust	n.
txonkrr	öösel	adv.
yuey	ilus (sisemine ilu)	adj.
kxem	vertikaalne olema	vin.
txay	horisontaalne olema	vin.
nìkxem	vertikaalselt	adv.
nìtxay	horisontaalselt	adv.
klltxay	maas lebama	vin.
klltxeykay	maha asetama  (klltxay sihiline vorm)	vtr.
yo	pind, kate	n.
kxemyo	sein, vertikaalne pind	n.
fyep	käes hoidma, haardes hoidma	vtr.
nìk'ärìp	kindlalt (mitte laskma liikuda)	adv.
nìklonu	kindlalt, tugevalt (mitte lahti laskma)	adv.
nìktungzup	kindlalt, ettevaatlikult (mitte kukkuda laskma)	adv.
nìsyep	kindlalt, raudselt (nagu lõksus)	adv.
nìmeyp	nõrgalt, vabalt	adv.
säfyep	käepide, sang vms.	n.
slan	toetama, abistama (emotsionaalselt, sotsiaalselt)	vtr.
tìslan	tugi, abi (emotsionaalne, sotsiaalne) (inimeste kohta)	n.
tìeyktan	juhikoht, juhtimine	n.
'llngo	puus	n.
zare'	otsaesine, laup	n.
flawm	põsk	n.
prrku	süli, rüpp (või ka emakas)	n.
ngep	naba	n.
tawsyuratan	virmalised	n.
syeha	hingus, hingetõmme	n.
syeha si	hingama	vin.
sko	olev kääne (kellegina, millegina)	adp.
sna'o	grupp, kogumik, hulk, kogum (elutu kohta)	n.
snatxärem	luukere	n.
snafpìlfya	filosoofia	n.
snatanhì	tähtkuju	n.
sästarsìm	kogum, kogumik (teadlikult kokku pandud kellegi poolt)	n.
tsu'o	oskus, võime	n.
krra	ajal, kui	conj.
snatanhìtsyìp	tähekogu	n.
pìwopxtsyìp	udukogu	n.
tìterkup	surm (abstraktne) (surm on paratamatu)	n.
maweypeyyu	rahulolija	n.
ftxulì'u	kõnelema, kõne edasi andma	vin.
ftxulì'uyu	kõneleja	n.
säftxulì'u	kõne, jutlus	n.
tìftxulì'u	kõnelemine, avalik kõnelemine	n.
slantire	inspiratsioon	n.
slantire si	inspireerima	vin.
kum	tulemus, järeldus	n.
kuma	seeõttu, mistõttu; kasutatakse järelduse ees, nt. 'Lu poe sevin nìftxan kuma yawne slolu oer' (Ta oli nii ilus, mistõttu ma armusin.); vaata ka 'akum'	conj.
akum	seetõttu, mistõttu; kasutatakse järelduse ees, nt. 'Poe yawne slolu oer akum, nìftxan lu sevin' (Ta oli nii ilus, mistõttu ma armusin.); vaata ka 'kuma'	conj.
fyel	tugevasti sulgema, kinni panema, kinnitama	vtr.
zey	eriline, harudane	adj.
vll	näitama, osutama	vin., vtr.
eykyu	juht (ajutine, näiteks jahi ajal)	n.
am'ake	enesekindel	adj.
nam'ake	enesekindlalt	adv.
kezemplltxe	muidugi mõista, ilma ütlematagi (lühenenud lausest kezenepivlltxe)	adv.
tare	ühilduma, mõistma, seost omama	vtr.
nìsoaia	(koos) nagu perekond	adv.
nìolo'	(koos) nagu hõimu liikmed	adv.
sätare	suhe	n.
sloa	lai	adj.
snep	kitsas	adj.
slosnep	laius	n.
peslosnep	kui lai?, mis laius?	inter.
slosneppe	kui lai?	inter.
hoet	kaugeleulatuv, laiaulatuslik	adj.
nìhoet	laiaulatuslikult, kaugeleulatuvalt	adv.
so'ha	vaimustuses olema, erutatud olema, vaimustust näitama (alati sihiline)	vtr.
tìso'ha	vaimustus, hea tuju	n.
nìso'ha	vaimustatult	adv.
leso'ha	vaimustunud	adj.
tsawlultxa	suur kogunemine, koosolek	n.
zìsìtay	järgmine aasta	n.
tìtsunslu	võimalus	n.
numultxa	klass (koolis)	n.
numultxatu	klassikaaslane	n.
snanumultxa	tund (koolis), loeng	n.
tìflä	edu (üldine)	n.
säflä	edu (mingi sündmusega)	n.
mesrram	üleeile	n., adv.
mesrray	ülehomme	n., adv.
pxesrram	kolm päeva tagasi	n., adv.
pxesrray	kolme päeva pärast	n., adv.
mong	sõltuma, toetuma (abile)	vtr.
sru'	trampima, purustama	vtr.
'ekxin	tihke, tihe	adj.
um	lõtv	adj.
'ekxinum	tihedus, lõtvus	n.
pekxinum	kui tihe, lõtv?	inter.
zeswa	muru, rohi	n.
zeswavi	rohulible	n.
lezeswa	rohune	adj.
lopx	paanitsema	vin.
hifwo	põgenema, jalga laskma	vin.
yrrap	torm	n.
'rrpxom	kõu	n.
rawm	äike	n.
rawmpxom	äike ja müristamine	n.
se'ayl	üksik pikk juga või kosk, mis voolab kaljult või Hõljuvatelt Mägedelt (loendatav)	n.
kxor	Suured kosed, mis on väga tugeva vooluga (loendatav, kuid harva)	n.
syanan	väiksemad kosed, kus vesi langeb astmeliselt	n.
rurur	oja moodi kivide vahel voolav vesi (loendatav)	n.
tseltsul	kärestik (loendatav, kuid harva)	n.
tìmeyp	nõrkus	n.
am'aluke	ilma kahtluseta, kahtlemata	adv.
atanzaw	ahelvälk	n.
nìsìlpey	loodetavasti	adv.
talun	sellepärast et	adp.
nìTsyungwen	Zhongwen	adv.
reykol	muusikat mängima, laulma	vtr.
nrra	uhkus, uhke tunne	n.
lenrra	uhke	adj.
nìnrra	uhkelt, uhkusega	adv.
snonrra	eneseuhkus (negatiivne alatoon)	n.
lesnonrra	ennast täis	adj.
nrr	helendama, kumama	vin.
ylltxep	ühislõkkeplats	n.
txeptseng	koht, mis põleb, lõkkekoht	n.
ralnga'	mõttekas, tähendusrikas; midagi, millest õppida	adj.
munsna	paar	n.
fyin	lihtne	adj.
ep'ang	keeruline, keerukas	adj.
epxang	kivist purk mürgise ämbliku jaoks	n.
fyinep'ang	raskusaste	n.
pefyinep'ang	kui keeruline?	inter.
fyinep'angpe	kui keeruline?	inter.
sngä'itseng	alguspunkt, esialgne asukoht	n.
srungsiyu	abistaja, assistent	n.
srungtsyìp	abistav vihje	n.
spulmokri	telefon	n.
syeprel	kaamera	n.
swoa	vägijooks, narkootiline jook, mõnujook	n.
rou	purjus olema, purju jääma (Näiteks: Rou fa pxir.	vin.
pamrelvi	kirjatäht	n.
snapamrelvi	tähestik	n.
tìtxen si	üles ärkama, ärkama	vin.
fnetxum	allergeen, allergia tekitaja	n.
zet	kohtlema, hoiakut üles näitama	vtr.
ha'	sobituma, sobima kokku	vin.
syon	omadus, loomus, iseloomujoon	n.
ran	üldine olek või seisund looduses, olemus, inimeste puhul iseloom.	n.
fyole	ideaalne, imeline	adj.
loran	graatsilisus, elegantsus	n.
fe'ran	vigane, halb olek	n.
reyfya	kultuur, elamisviis	n.
fe'ranvi	rikutud, vigane olek	n.
nìran	põhimõtteliselt, tegelikult, oma olemuselt	adv.
mo	koht, piiratud ala, ruum	n.
snomo	personaalne ruum	n.
wum	umbes	adv.
kesran	nii ja naa, normaalne (pole jah, pole ei) /bf kesrankekehe	adj.
nìksran	keskmiselt, normaalselt	adv.
yewla	pettumus, läbi kukkunud ootus.	n.
leyewla	pettumust valmistav	adj.
nìyewla	pettunult, ootusi mitte täitvalt	adv.
yawnyewla	murtud süda	n.
ve'o	kord, organiseeritus	n.
vezo	korras olema, organiseeritud olema	vin.
vezeyko	korrastama, korda seadma, organiseerima	vtr.
vefya	süsteem, protsess, lähenemisviis	n.
velke	kaoseline, segane, korralage	adj.
venga'	organiseeritud	adj.
nìfnu	vaikselt	adv.
sätaron	jaht (nt. sinihirvejaht)	n.
wäsul	võistlema	vin.
tìwäsul	võistlemine	n.
säwäsul	võistlus	n.
säwäsultsyìp	mõõduvõtt, väiksem võistlus	n.
tìmwiä	õiglus, ausus	n.
snew	pigistama, pitsitama	vtr.
txantxew	maksimum	n.
snewsye	imelik, õudne, jube	adj.
hìmtxew	miinimum	n.
txantxewvay	maksimaalselt	adv.
hìmtxewvay	minimaalselt	adv.
hefi	tundma (lõhna, haisu)	vtr.
ewku	maitset tundma	vtr.
zìm	tundma, tunnetama (mitte sihilikult)	vtr.
yune	kuulama (sihilikult)	vtr.
syam	nuusutama	vtr.
'ur	vaade, välimus	n.
sur	maitse, maik	n.
zir	puudutus, tunne, tekstuur	n.
tse'atswo	nägemine (taju)	n.
stawmtswo	kuulmine (taju)	n.
hefitswo	haiistmine (taju)	n.
ewktswo	maitsmine (taju)	n.
zìmtswo	kompimine (taju)	n.
fkan	tunduma, välja paistma	vin.
onlor	lõhnav	adj.
onvä'	haisev	adj.
we'ay	hapu	adj.
wip	soolane	adj.
fwang	piprane	adj.
nget	mädaneva puidu ja lehtede hais	adj.
kxänäng	roiskuva looma või liha hais	adj.
sosul	voolava vee, vihma, niiskuse lõhn	adj.
unyor	meeldivalt aromaatne (lillelõhn või mõnede vürtside lõhn)	adj.
atxar	loomade lõhn, võib veekogu ümber leida.	adj.
inanfya	taju	n.
uvan letokx	sport, füüsiline harjutus/mäng	n.
ftärpa	vasak pool	n.
skiempa	parem pool	n.
rengop	kujundama, disainima	vtr.
tìrengop	kujundamine, disainimine	n.
särengop	kujundus, disain	n.
ingyen	arusaamatuse, mõistmatuse tunne	n.
sngumtsim	mureallikas, murettekitav asjaolu	n.
yayayrtsim	segaduseallikas	n.
ingyentsim	müsteerium, mõistatus, arusaamatus	n.
ingyentsyìp	trikk, nüanss	n.
ningyen	kummaliselt, arusaamatult, segadusseajavalt	adv.
ingyenga'	arusaamatu, segane, kummaline	adj.
sngunga'	muretsema ajav, murelikuks tegev	adj.
yayayrnga'	segadusrohke	adj.
yrr	loomuomane, looduslik (puutumata ja muutmata tavaolekus olev asi)	adj.
nìyrr	loomupäraselt	adv.
zäfi	segatud, muudetud, modifitseeritud, mitte oma loomuomases vormis	adj.
syor	rahunema	vin.
tìsyor	rahunemine	n.
tìfnunga'	vaikne	adj.
späpeng	end taastama, taastuma (metafooriline)	vin.
'anla	igatsema	vtr.
sä'anla	igatsus	n.
lie	kogemus	n.
tsìlpey	lootus (abstraktne idee)	n.
säsìlpey	lootus (kindla juhtumi puhul)	n.
kelsar	mõttetu, kasutu	adj.
yì	äär, tase, aste, tasand (saab kasutada metafooriliselt mõõdetavate asjade puhul: veetase, temperatuur, oskused, rõõmsameelsus, raskusastmed jne.)	n.
snayì	trepp, rida astmeid	n.
kxaylyì	kõrge tase	n.
kxamyì	kesmine tase	n.
tìmyì	madal tase	n.
flrr	õrn, hooliv (nii elus kui eluta puhul)	adj.
nìflrr	õrnalt, hoolivalt	adv.
tìflrr	õrnus, hoolivus	n.
ngä'än	vaimselt või emotsionaalselt kannatama, õnnetu olema	vin.
kelkin	ebavajalik, põhjuseta	adj.
nìkelkin	ilma vajaduseta	adv.
sängä'än	depressioon, kannatav olek	n.
'eylanay	tuttav (potentsiaalne sõber)	n.
eyktanay	asetäitja, üks aste juhist madalamal olija	n.
tsulfätunay	peaaegu meister	n.
karyunay	õpetajaks õppija	n.
tsan'ul	paranema	vin.
fe'ul	halvenema	vin.
tìtsan'ul	paranemine (abstraktne)	n.
tìfe'ul	halvenemine (abstraktne)	n.
sätsan'ul	paranemine (kindlal juhtumil)	n.
säfe'ul	halvenemine (kindlal juhtumil)	n.
frafya	igal võimalikul viisil, igat moodi	adv.
postì	postitus (foorumis, blogis)	n.
ketsran	tähtsusetu, vähetähtis, misiganes, vahet pole	adj.,  conj.
kangay si	kindlaks tegema, kinnitama, valideerima	vin.
txurtel	köis	n.
ropx	auk (täielikult läbistav)	n.
tsongropx	auk, avaus (olemasoleva põhjaga)	n.
tsrul	pesa; Pandora loomade kodu	n.
yayotsrul	linnupesa	n.
lini	noorloom, kala, lind, putukas	n.
tarnioang	kiskja	n.
rong	tunnel	n.
swek	pulk, post	n.
mektseng	avaus	n.
tsenga	koht kuhu	conj.
fta	sõlm	n.
fta si	sõlme tegema, sõlmima	vin.
fwi	(käest) libisema	vin.
oìsss si	sisisema	vin.
il	painduma	vin.
kxakx	pooleks murduma	vin.
ftumfa	st, seestütlev (millegi seest)	adp.
sä'eoio	rituaal, tseremoonia	n.
sä'eoio si	rituaali läbi viima, tseremooniast osa võtma	vin.
kur	rippuma	vin.
nìtkan	meelega, tahtlikult, sihilikult	adv.
nìtkanluke	kogemata, tahtmatult	adv.
nui	ebaõnnestuma, läbi kukkuma, feilima, mitte saavutama soovitud tulemust	vin.
nìnu	ebaõnnestuvalt, valesti (Näide Oeru txoa livu. 'olängeyng nìnu  Vabandust, valesti vastasin	adv.
tìnui	läbikukkumine, ebaõnnestumine (abstraktne)	n.
sänui	läbikukkumine, ebaõnnestumine (kindel olukord)	n.
fngä'	end kergitama; (Maal) WCd kasutama	vin.
zun	kui (vastupidise olukorra puhul, võrdle txo, Näide Zun zivup tompa, zel ke tsivun oe kivä.  Kui vihma sajaks, siis ma ei saaks minna)	conj.
zel	siis (vastupidise olukorra puhul, võrdle tsakrr, Näide Zun zivup tompa, zel ke tsivun oe kivä.  Kui vihma sajaks, siis ma ei saaks minna)	adv.
'ekxinumpe	kui tihe, lõtv?	inter.
okup	piim	n.
loi	muna	n.
tsyeym	aare; suure väärtusega või harvaesinev asi.	n.
wokau	pendeltrumm	n.
srä	riie	n.
srok	pärl, helmes (kaunistamiseks)	n.
pxayopin	kirju, mitmevärviline	adj.
tsyoklìt	šokolaad	n.
paynäpll	ananass	n.
pamrelsiyu	kirjanik	n.
rel arusikx	film, video	n.
lì'upuk	sõnastik, sõnaraamat	n.
lì'upuk	sõnastik, sõnaraamat	n.
nìkemweypey	kannatamatult, kärsitult	adv.
kelemweypey	kannatamatu, kärsitu	adj.
'on	kuju, vorm	n.
salewfya	suund, kurss	n.
koum	ümar, kurvikas	adj.
ko'on	ring, ovaal, ringilkujuline vorm	n.
yo'ko	ring	n.
renulke	ebakorrapärane, juhuslik	adj.
vawt	tahke, mitte õõnes	adj.
momek	õõnes, mitte tahke	adj.
yeyfya	sirge, sirge joon	n.
yak	hargnemispunkt, lahknemispunkt	n.
yak si	kõrvale kalduma, suunda muutma	vin.
nìyeyfya	otse, sirgelt	adv.
nìftär	vasakule	adv.
nìskien	paremale	adv.
'oratsyìp	tiik	n.
nìyawr	õigesti, korrektselt	adv.
tìsteftxaw	uurimine	n.
yoa	vahetuseks millegi eest (Oel tolìng ngaru tsnganit yoa fkxen. Ma andsin sulle juurvilju liha eest)	adp.
txolar	dollar	n.
ewro	euro	n.
lawnol	suur rõõm	n.
ley	väärtust omama, väärt olema	vin.
säfmi	proov, katsetus	n.
nìfkeytongay	tegelikult, ausalt öeldes	adv.
mowar	nõuanne, soovitus	n.
mowar si	nõu andma, soovitama	vin.
mowarsiyu	nõuandja	n.
kakpam	kurt	adj.
tìkakpam	kurtus	n.
pxek	lööma, laksama	vtr.
kolan	tähendab, õigupoolest (eelnevalt öeldu täpsustus/parandamine)	intj.
hena	kandma	vtr.
sähena	karp; asi, milles saab asju hoida	n.
paysena	anum vee hoidmiseks	n.
tutsena	kanderaam (ese, millega filmis Grace'i lohistati)	n.
tstalsena	noatupp	n.
swizawsena	nooletupp (Ikrani sadula küljes)	n.
tìkakrel	pimedus (mitte nägemine)	n.
ngoa	muda	n.
mawfwa	pärast	conj.
neni	liiv	n.
fwep	tolm (mingi pinna peal)	n.
fwopx	tolm (õhus lendlev)	n.
nìyey	otse, sirgelt, otsekoheselt	adv.
'al	raiskama, kulutama	vtr.
tì'al	raiskamine	n.
le'al	raiskav (mitte inimeste kohta)	adj.
nì'al	raiskavalt	adv.
srey	variant, versioon	n.
lupra	stiil	n.
fyolup	ülimalt stiilne, peen	adj.
fe'lup	kõhetu, vähese stiiliga	adj.
snolup	kohalolu, väljanägemine, isiklik stiil	n.
'ongop	disain, kujundus	vtr.
'ongopyu	disainer, kujundaja	n.
uniltìrantokxolo'	klann, avataride grupp	n.
krrka	sellal, ajal kui	adp.
tìreyn	rong	n.
LosÄntsyelesì	Los Angeles	pn.
tson	kohustus, nõutav tegu	n.
nìtson	kohusetundlikult	adv.
kxìm	käskima, määrama	vtr.
tsonta	kohustust, mida (koos sõnaga kxìm)	conj.
tìkxìm	käskimine, määramine	n.
tìkxìm si	hierarhias kõrgemal asuma, ülemus olema	vin.
kxìmyu	väejuht, teise/teiste üle võimu omav isik	n.
saylahe	ja teised, et cetera	adv.
fpomron	tervis, heaolu (vaimne; inimeste kohta)	n.
lefpomron	terve (vaimselt; inimeste kohta)	adj.
kelfpomron	ebatervislik (vaimselt; inimeste kohta)	adj.
fpomtokxnga'	tervislik(füüsiliselt; mitte inimeste kohta)	adj.
kefpomtokxnga'	ebatervislik, (füüsiliselt; mitte inimeste kohta)	adj.
fpomronga'	tervislik (vaimselt; mitte inimeste kohta)	adj.
kefpomronga'	ebatervislik (vaimselt; mitte inimeste kohta)	adj.
srefpìl	eeldama	vtr.
srefwa	enne seda, kui	conj.
ken'aw	mitte ainult	adv.
släkop	aga ka	adv.
sngum si	muretsema	vin.
väpam	kole või ebameeldiv heli, kriiksumine	n.
hawmpam	müra; heli, mis on liigne, ebavajalik, mõttetu	n.
lehawmpam	lärmakas	adj.
nìhawmpam	lärmakalt	adv.
miklor	hästikõlav, ilusalt kõlav	adj.
mikvä'	halvasti kõlav, koledalt kõlav	adj.
narlor	visuaalselt ilus, kena	adj.
narvä'	kole, silmale halb vaadata	adj.
zawr	loomah äälitus	n.
tìnew	iha, ihalus	n.
nopx	ära panema, hoiule panema	vtr.
tiam	loendama	vtr.
ketsuktiam	loendamatu, lõpmatu	adj.
txewluke	lõputu, piiritu	adj.
'umtsa	ravim, rohi	n.
lang	uurima, tundma õppima	vtr.
tìlang	uurimine	n.
sälang	uurimus	n.
kxum	viskoosne, limane, paks	adj.
kxumpay	lima, geel, viskoosne vedelik	n.
sängop	looming, teos	n.
tsyìl	ronima (kogu keha üles tõmbama)	vtr.
kxap	oht	n.
kxapnga'	ohtlik, ähvardav (mitte inimeste kohta)	adj.
nìkxap	ohtlikult, ähvardavalt	adv.
tìftiatu	uurija	n.
tìftiatu kifkeyä	teadlane	n.
heyr	rind	n.
tseri	märkama, tähele panema	vtr.
kxap si	ohustama, ähvardama	vin.
tìtseri	tähelepanu, märkamine	n.
tìktseri	tähelepanematus	n.
yäkx	ignoreerima, tähelepanu mitte omistama (negatiivne)	vtr.
tìyäkx	ingoreerimine (abstraktne)	n.
srunga'	abivalmis	adj.
säyäkx	ingoreerimine (juhtum)	n.
ngip	ruum, vaba või piirideta ala	n.
txepram	vulkaan	n.
txekxumpay	magma, laava	n.
wrrza'u	välja tulema	vin.
tskxevi	kivike, väike looduses siledaks lihvitud kivi	n.
nìkx	kruusakivi, looduses või tehislikult purustatud kivi tükk	n.
tìralpeng	tõlge, tõlgendus, interpretatsioon	n.
unil si	und nägema	vin.
uniltsa	unes nägema	vtr.
mauti	puuvili	n.
utu	ala metsas, mida täidavad puude lehed, lehistu	n.
utumauti	banaan	n.
slayk	kamm	vtr.
tìkelu	puudus	n.
tompakel	põud	n.
syuvekel	nälg	n.
zawprrte'	meelepärane olema, nauditav olema	vin.
nawri	andekas	adj.
tìnawri	anne, talent	n.
susyang	õrn, habras	adj.
reym	kuiv maa	n.
kop	ja ka	conj.
tuvom	parim, suurim	adj.
yengwal	kurbus	n.
nip	kinni jääma	vin.
hän	võrk	n.
'rrko	rulluma	vin.
tsngem	lihas	n.
tsawsngem	lihaseline	adj.
wìngay	tõestama	vtr.
tìwìngay	tõestus (abstraktne)	n.
säwìngay	tõend, tõestus (juhtum)	n.
tìng zekwä	puudutama, katsuma (tahtlikult)	vin.
weptseng	veebilehekülg, veebisait	n.
wep	internet, veeb (www.)	n.
tseotu	artist, kunsti looja (üldine mõiste)	n.
tìkeftxo	kurbus	n.
tìkeftxonga'	kurb	adj.
pamtseongopyu	helilooja, muusika looja	n.
lereyfya	kultuurile omane, kultuurne	adj.
huru	pott	n.
sey	anum vms ese mis on kohandatud minimaalselt looduses leiduvast	n.
'e'in	kaun	n.
'e'insey	joogikaun	n.
sum	teokarp	n.
sumsey	teokarbist tehtud joogianum	n.
swoasey	kava anum (seemnekaunadest tehtud anum vägijookide tarvitamiseks), käes hoitav	n.
swoasey ayll	suur kava anum	n.
tsyey	snäkk, oode, kerge eine	n.
tsyeytsyìp	hambatäis	n.
nik	mugav, lihtne	adj.
niktsyey	söödavavad toitu siduvad lehed vms	n.
merki	grill 	n.
ikut	suur uhmrinui; lihasegisti	n.
sämunge	transpordivahend (tööriist vms)	n.
syusmung	toidualus	n.
paysmung	veepaun	n.
prrsmung	beebi hoidja	n.
nivi	võrkkiik (magamiseks, üldine termin)	n.
swaynivi	perekonna võrkkiik	n.
snonivi	ühe inimese võrkkiik	n.
sänrr	helendus, helendamine; valgusallikas, lamp	n.
tsmi	nektar	n.
tsmisnrr	põis, latern	n.
seyn	tool, pink; istumiseks mõeldud ese	n.
hoan	mugavus	n.
lehoan	mugav	adj.
nìhoan	mugavalt	adv.
kelhoan	ebamugav	adj.
fyan	ese, millele saab asju panna, et nad maas ei oleks	n.
fyanyo	laud, alus	n.
yomyo	taldrik	n.
yomyo lerìk	lehttaldrik	n.
fyanyì	riiul	n.
kurfyan	korv, rippuv iste	n.
snokfyan	isiklike asjade korv	n.
kurfyavi	konks	n.
seyto	lihunik	vtr.
säseyto	lihuniku tööriist	n.
yaney	kanuu	n.
spulyaney	kanuu aer	n.
lal	vana (mip vastand)	adj.
txanlal	muistne, antiikne, väga vana	adj.
tsankum	eelis, kasu, võit	n.
tsankumnga'	kasulik, soodne	adj.
fekumnga'	ebasoodne	adj.
tìmungwrr	erand	n.
tìmungwrr si	erandit tegema	vin.
nawfwe	sorav	adj.
fekum	kahju, takistus, halb pool, kaotus	n.
plltxeyu	rääkija, kõneleja	n.
pxawngip	keskkond	n.
palulukantsyìp	kass (Maal); surmapantrikene	n.
zum	ese, asi (füüsiliselt olemasolev)	n.
hìpey	kõhklema	vin.
tìhìpey	kõhklus	n.
snäm	roiskuma, kõdunema, lagunema aja jooksul	vin.
kllrikx	maavärin	n.
sälatem	muudatus, muutmine, modifitseerimine	n.
tìlatem	muutus (abstraktne)	n.
txatx	mull	n.
lehìpey	kõhklev	adj.
nìhìpey	kõhklevalt	adv.
ronguway	ulguma	vin.
ronguwayyu	ulguja	n.
ler	sujuv, ühtlane, tasane (liikumise kohta)	adj.
nìler	sujuvalt, ühtlaselt, tasaselt	adv.
lo'a	tootem, hõimu märk	n.
'ewrang	kudumismasin	n.
sa'ewrang	suur kudumismasin	n.
tiretu	šamaan	n.
pasuk	mari	n.
vozampasukut	tuhande marja puu, maripuu	n.
paskalin	magus mari	n.
fngä'tseng	tualett, WC	n.
mo a fngä'	tualett, WC	n.
sa	väljakutseks ettevalmistuma	vin.
tanleng	puukoor	n.
syokup	kaal (füüsikaline)	n.
kewan	vanus	n.
tìnvi	ülesanne, samm, asi	n.
tìnvi si	ülesannet sooritama, asja ajama ("kohtume pärast, mul on praegu asju ajada")	vin.
txanwetseng	isikule tähtis või armas koht	n.
penghrr	hoiatama	vin.
säpenghrr	hoiatus	n.
tì'ul	suurendama	n.
eyawrfya	õigesti (millegi tegemine), õige viis	n.
stiwi	pahandus, koerustükk	n.
stiwi si	ulakas, üleannetu, riukalik olema	vin.
stiwinga'	ulakas, üleannetu, riukalik	adj.
stiwisiyu	pahanduse korraldaja	n.
rawng	sissekäik, ukseava	n.
syewe	rasv	n.
syewenga'	rasvane	adj.
laro si	puhastama, mustusest/porist puhtaks tegema	vin.
slukx	loomasarv	n.
tsin	küüs, küünis	n.
ue'	oksendama	vtr., vin.
nantangtsyìp	koer (maal); väike soomushunt	n.
hiup	sülitama	vin., vtr.
räptum	ebaviisakas, sotsiaalselt ebasobilik, vulgaarne, ropp	adj.
txanlokxe	hõimu territoorium, riik	n.
tsamsä'o	sõjariist	n.
tìtxurnga'	võimas (elutu kohta)	adj.
leym	hüüdma, karjuma	vim.
nìzen	kindlasti, ilmtingimata	adv.
kenzen	mitte ilmtingimata	adv.
pllhrr	hoiatama	vin.
säpllhrr	hoiatus	n.
