"Frontside"	"Flipside"	"Category"
'ampi	(meg)érint	vtr.
'angtsìk	kalapácsfejű növényevő (pandorai állatfaj)	n.
'aw	egy, 1	num.
'awkx	szikla(szírt)	n.
'awpo	egy személy (általános alany)	pn.
'awsiteng	együtt, közösen	adv.
'awve	első	adj.
'e'al	legrosszabb	adj.
'eko	támad	vtr.
'ekong	ritmus, ütem	n.
'engeng	szint, emelet	adj.
'eveng	gyermek	n.
'evi	gyerkő(c) (affectionate form of)	n.
'ewan	fiatal	adj.
'eylan	barát	n.
'ì'awn	marad	vin.
'ìheyu	spirál	n.
'Ìnglìsì	angol nyelv	n.
'it	kevés (kis mennyiség)	n.
'itan	fiúgyermek	n.
'ite	lánygyermek	n.
'ok	emlék, emlékezés	n.
'ong	kinyílik, kivirágzik	v.
'u	dolog (valami)	n.
'upe	mi? mit? micsoda? micsodát?	inter.
'upxare	üzenet	n.
a	aki, amely(ik) (határozói mellékmondat kötőszava)	part.
alaksi	kész, felkészült	adj.
lìm	messze van	svin.
apxa	nagy	adj.
atan	fény	n.
atokirina'	A Szent Fa magja	n.
atxkxe	föld, terület	n.
au	dob (bőrből készült)	n.
aungia	(elő)jel, ómen	n.
awaiei	édeni sikoltófű, földi ikran (pandorai növényfaj)	n.
awnga	mi	pn.
ayfo	ők sokan	pn.
aynga	ti sokan	pn.
ayoe	mi (kizáró)	pn.
ayoeng	mi (beleértő)	pn.
äie	vízió, látomás	n.
äo	alatt(a), alul	adp.
ätxäle	kérés	n.
ätxäle si	kérés (tsnì majd a tárgyi mellékmondat)	vin.
ean	kék, zöld	adj.
eltu	agy	n.
eltu si	figyel	vin.
eltungawng	agyféreg (pandorai állatfaj)	n.
emza'u	kiáll, sikerrel vesz (próbát)	vtr.
eo	előtt(e),elől	adp.
eyawr	helyes, jó (válasz)	adj.
eyaye	eyaye (pandorai növényfaj)	n.
eyk	vezet (népet)	vtr.
eyktan	vezető, főnök	n.
fa	val/vel/által (eszközhatározó)	adp.
fahew	szag	n.
fìfya	így, ilyen módon	adv.
fìkem	ez (a tett/cselekvés)	pn.
fìpo	ő, ez a személy	pn.
fìtxan	ennyire, ilyen mértékben	adv.
fìtseng	itt, ez(en) a hely(en)	adv., n.
fìtsenge	itt, ez(en) a hely(en)	adv., n.
fì'u	ez (a dolog)	pn.
fkarut	hámoz	v.
fkew	hatalmas, tekintélyes	adj.
fko	valaki, ő(k) (határozatlan alany, egyesszámban értendő)	pn.
flä	sikerrel jár, sikerül	vin.
fmawn	hír, újság	n.
fmetok	tesztel, próbára tesz	vtr.
fmi	(meg)próbál, megkísérel	vtrm.
fngap	fém	n.
fngapsutxwll	fémkövető növény (pandorai növényfaj)	n.
fnu	lehalkít, elcsendesül	vin.
fo	ők sokan	pn.
fpak	abbahagy, felfüggeszt (a cselekvés folytatódni fog)	v.
fpe'	(el)küld	vtr.
fpeio	kihívás (ünnepélyes)	n.
fpi	(azért), hogy; valaminek az érdekében	adp.
fpìl	gondol(kodik)	vtr.
fpom	béke, jólét	n.
fpxafaw	(pandorai repülő medúzaszerű lény) (pandorai állatfaj)	n.
fpxäkìm	belép	vin.
fra'u	minden	pn.
frakrr	mindig	adv.
frapo	mindenki	pn.
frrfen	(meg)látogat	vtr.
frrtu	vendég	n.
ftang	befejez, abbahagy	vim.
fte	a célból/azért, hogy	conj.
fteke	hogy nehogy, különben	conj.
ftia	megfigyel, szemügyre vesz, tanulmányoz	vtr.
ftxì	nyelv (testrész)	n.
ftxozä	ünnep(ség)	n.
ftu	felől, irányából	adp.
ftue	könnyű, egyszerű	adj.
ftxavang	szenvedélyes	adj.
ftxey	választ	vtr.
fu	vagy (kötőszó)	conj.
futa	azt, hogy (alárendelő mellékmondat kötőszava)	pn., sbd.
fwa	az, hogy (alárendelő mellékmondat kötőszava)	pn., sbd.
fya'o	ösvény, út, mód	n.
fyape	hogy(an)?	inter.
fyawìntxu	vezet, utat mutat	vin.
ha	úgy, akkor, abban az esetben	adv.
hahaw	alszik	vin.
hapxì	rész	n.
hasey	kész, befejezett	adj.
hawnu	(meg)véd, (meg)óv	vtr.
hì'i	kicsi, apró, parányi	adj.
hiyìk	különös, furcsa	adj.
hol	néhány, kevés	adj.
holpxay	szám	n.
hrrap	veszély	n.
hu	val/vel (társhatározó)	adp.
hufwe	szél (szellő)	n.
hum	elmegy, elhagy	vin.
i'en	húros hangszer	n.
ikran	ikran/sikoll (na'vik repülő hátasa) (pandorai állatfaj)	n.
ikranay	erdei ikran/sikoll	n.
ioang	állat, vadállat	n.
irayo	köszönet, köszönöm!	n., intj.
ìlä	által(a), révén, keresztül, mentén	adp.
ka	túl(ra), át(al)	adp.
kä	megy	vin.
kali'weya	mérgező pókszabású állat (pandorai állatfaj)	n.
kalin	édes (íz)	adj.
kaltxì	szia!, üdvözöllek! (találkozáskor)	intj.
kämakto	kilovagol	v.
kame	(bele)lát (spirituális értelemben), lény(eg)ében megért/felismer, 'grokkol'	vtr.
kan	(meg)céloz	vtrm., vtr.
kangay	érvényes	adj.
kar	tanít	vtr.
karyu	tanító	n.
kato	ritmus	n.
kawkrr	soha	adv.
kawng	rossz, gonosz	adj.
kawtu	senki	pn.
ke	nem	adv.
ke'u	semmi	pn.
kehe	nem (tagadás)	part., intj.
kelku	otthon, ház	n.
kelku si	lakik	vin.
kem	cselekedet, tett	n.
kempe	mi történik? mit csinál?	inter.
kenong	példát mutat, elől jár	vin.
kerusey	halott	adj.
ketuwong	idegen, ismeretlen személy	n.
kewong	idegen, ismeretlen	adj.
keye'ung	őrület	n.
kifkey	világ (fizikai, kézzelfogható)	n.
kilvan	folyó	n.
kìm	forgat, pörget	vtr.
kin	szüksége van valamire	vtr.
kinam	láb	n.
kinamtil	térd	n.
kìng	fonal	n.
kip	között(e)	adp.
kìte'e	szolgálat	n.
kllfro'	felelős valamiért	svin.
kllkulat	felás	vtr.
kllkxem	áll	vin.
kllpxìltu	terület	n.
kllte	föld, talaj	n.
ko	nosza!	part.
kop	is, szintén	adv.
koren	szabály	n.
krr	idő	n.
krrnekx	időt vesz igénybe (ii)	vin.
krrpe	mikor?	inter.
kunsìp	harci helikopter	n.
kurakx	kiűz, elüldöz	vtr.
kxam	közép, középpont	n.
kxamtseng	központi hely	n.
kxangangang	bumm! (hangutánzószó)	intj.
kxanì	tiltott	adj.
kxawm	talán, esetleg	adv.
kxener	füst	n.
kxetse	farok	n.
kxeyey	hiba	n.
kxll	lerohanás	n.
lahe	más	adj.
lam	látszik, (fel)tűnik	vin.
lapo	más, másik ember vagy dolog	pn.
latem	változik	vin.
law	tiszta, világos, bizonyos	adj.
lefpom	nyugodalmas, derűs, kellemes	adj.
lertu	kolléga	n.
letrr	mindennapi	adj.
letsunslu	lehetséges	adj.
lì'u	szó	n.
lì'fya	nyelv	n.
lok	megközelít	vtr.
lonu	elereszt	vtr.
lor	gyönyörűséges, kellemes	adj.
loreyu	helicoradium spirál, gyönyörű spiral (pandorai növényfaj)	n.
lrrtok	mosoly	n.
lrrtok si	mosolyog	vin.
lu	van, lenni	vin., svin.
lun	ok, indok	n.
lumpe	miért?	inter.
ma	megszólító eset jele	part.
makto	lovagol, megül	vtr.
mawey	nyugodt	adj.
mefo	ők ketten	pn.
menari	két szem	n.
meoauniaea	harmónia, összhang a természettel	n.
meuia	becsület, tisztesség	n.
meyp	gyenge	adj.
mi	még mindig	adv.
mip	új	adj.
mikyun	fül	n.
mì	bent, benne, rajta, ban/ben, on/en/ön	adp.
mìn	(meg)fordul, tengely körül forog	vin.
mìso	távol(ban)	adv.
mllte	egyetért	vin.
moe	mi ketten (kizáró)	pn.
mokri	beszédhang, énekhang	n.
muiä	igazságos, helyénvaló	adj.
mun'i	vág	v.
mune	kettő, 2	num.
munge	visz, hoz	vtr.
mungwrr	kivételével	adp.
muntxa	egyesült (pár)	adj.
na	ként, akként/úgy..., mint/ahogy	adp.
na'rìng	erdő	n.
Na'vi	a Nép, bennszülött pandorai faj	prop.n.
nang	hű! azta! hajrá! (meglepetést, biztatást jelölő szó, felkiáltás)	part.
nantang	viperafarkas Caniferratus costatus, síkos páncélos farkas (pandorai állatfaj)	n.
nari	szem	n.
nari si	vigyáz, odafigyel, óvatosan cselekszik	vin.
nawm	nagy, nemes	adj.
ne	felé, irányába	adp.
ne'ìm	hát(ul)ra, hátrafelé	adv.
nekx	eléget, elfogyaszt	vtr.
neto	el(felé)	adv.
new	akar	vtrm.
niä	megfog, megragad	vtr.
nì'aw	csak	adv.
nìawnomum	köztudottan, közismerten (köznapi beszédben: [naw.no.mum])	adv.
nì'awtu	egyedül	adv.
nì'awve	elsősorban, főként, leginkább	adv.
nì'it	kicsit, kevéssé	adv.
nì'ul	több	adv.
nìayoeng	mint mi (köznapi beszédben: [naj.wEN])	adv.
nìftue	könnyen, egyszerűen	adv.
nìftxavang	szenvedélyesen, teljes szívből	adv.
nìhawng	túlságosan, túlzó mértékben	adv.
nìltsan	jól	adv.
nìmun	újra	adv.
nìn	ránéz, megpillant	vtr.
nìngay	igazán	adv.
nìtam	elég	adv.
nìteng	ugyanúgy, hasonlóképpen	adv.
nìtut	folyamatosan	adv.
nìtxan	nagyon	adv.
nìwin	gyorsan	adv.
nìwotx	teljesen	adv.
nulkrr	hosszabb időtartamú	adv.
nulnew	jobban szeret, preferál	vtrm.
nume	tanul	vin.
nga	te	pn.
ngawng	féreg (pandorai állatfaj)	n.
ngay	igaz	adj.
ngenga	te (szertartásos forma)	pn.
ngim	hosszú	adj.
ngop	alkot, készít, létrehoz	vtr.
ngrr	gyökér	n.
nguway	vonyítás, a nantang üvöltése	n.
oe	én	pn.
oeng	mi ketten (beleértő) (te és én)	pn.
oeyk	ok, indok	n.
ohe	én (szertartásos forma)	pn.
olo'	klán	n.
olo'eyktan	törzsfő, klánvezető	n.
omum	tud	vtr.
ontu	orr	n.
pähem	(meg)érkezik, megjön	vin.
pak	fúj! (megvetést, lenézést jelöl)	part.
pa'li	Páncélos ló (Na'vik földi lószerű hátasa, pandorai állatfaj)	n.
palulukan	Thanator („száraz száj és félelemhozó”) (szárazföldi csúcsragadozó, állatfaj)	n.
pam	hang	n.
pamtseo	zene	n.
pamtseowll	macskafül, zenevirág (pandorai növényfaj)	n.
pängkxo	beszélget, társalog	vin.
pänutìng	ígér	vtr.
pätsì	jelvény	n.
pawm	kérdez	v.
pay	víz, folyadék	n.
paywll	vízvirág/vízinövény, dapofet, (pandorai növényfaj)	n.
pe	kérdőszóképző	affix
pe'un	(el)dönt	vtr.
pefya	hogy(an)?	inter.
pehem	mi történik? mit csinál?	inter.
pehrr	mikor?	inter.
pelun	miért?	inter.
peng	mond	vtr.
penghrrap	"veszélyjelző", rojtos lámpa (pandorai növényfaj)	n.
peseng	hol?	inter.
pesu	ki(csoda)?	inter.
peu	mi? mit? micsoda? micsodát?	inter.
pey	várni, vár valamire	vin.
pizayu	ős	n.
plltxe	beszél	v.
po	ő (hímnem/nőnem)	pn.
poan	ő (hímnem) (nincs többesszáma: helyette az (ay)fo)	pn.
poe	ő (nőnem) (nincs többesszáma: helyette az (ay)fo)	pn.
pongu	személyek csoportja	n.
prrnen	csecsemő, baba	n.
prrnesyul	bimbó, rügy	n.
prrte'	élvezetes, örömteli	adj.
pxan	méltó, érdemes	adj.
pxasìk	(Hagyd) a fenébe!	intj.
pxasul	friss, érett	adj.
pxay	számos	adj.
pxey	három, 3	num.
pxi	éles, hegyes	adj.
pxìm	gyakran	adv.
pxiut	borotva pálma, éles fa (pandorai növényfaj)	n.
pxorna'	episoth, robbanó mag (pandorai növényfaj)	n.
pxun	kar	n.
pxuntil	könyök	n.
rä'ä	ne! (tiltószó)	part.
ral	jelentés	n.
ralpeng	értelmez, tolmácsol	vtr.
rawke	vigyázz! menekülj! veszély! (figyelmeztető kiáltás)	intj.
rel	kép	n.
reltseo	képművészet	n.
reltseotu	művész (vizuális)	n.
renu	minta	n.
rey	él	vin.
rikx	mozog	vin.
rim	sárga	adj.
rina'	mag	n.
riti	Tüskés/Fullánkos denevér (pandorai állatfaj)	n.
rol	énekel	v.
ronsem	elme	n.
rum	labda	n.
rumut	labdafa (pandorai növényfaj)	n.
run	(meg)talál, felfedez	vtr.
rutxe	légy szíves! kérlek!	intj.
sa'nok	anya	n.
sa'nu	anyu (affectionate form of)	n.
san	idézet, függő beszéd kezdete	adv.
sänume	tanítás	n.
säspxin	betegség, kór	n.
sempu	apu (affectionate form of)	n.
sempul	apa	n.
set	most	adv.
sevin	csinos	adj.
seyri	ajak	n.
seze	"kék virág" (Neytiri ikranjának a neve) (pandorai növényfaj)	n.
si	ntesz, csinál, összetett igékben szerepel	
sì	és (connects two things, can be attached as --sÃ¬: for clauses use)	conj.
sìk	idézet, függő beszéd bezárása idézet vége	adv.
sìlpey	remél (tsnì majd a remélt dolog, hacsak nem különálló mondat) (ii)	vin.
sìlronsem	elmés, ötletes	adj.
sìltsan	jó (megfelelő)	adj.
ska'a	(el)pusztít, megsemmisít, lerombol	vtr.
skxawng	gyagyás, tökfej	n.
slä	de	conj.
slu	válik (valamivé)	vin.
sngä'i	(el)kezdődik	vim.
sngä'ikrr	kezdet	n.
sngel	szemét	n.
sngeltseng	szemétdomb	n.
snumìna	sötét, buta	adj.
som	forró	adj.
somtìlor	"gránátfű", forró szépség (pandorai növényfaj)	n.
spaw	hisz	vtr.
spxam	gomba	n.
spe'e	elfog, foglyul ejt	vtr.
spe'etu	fogoly	n.
spxin	beteg	adj.
srak	eldöntendő kérdés jele	part.
srake	eldöntendő kérdés jele	part.
srane	igen	part., intj.
srew	táncol	vin.
srung	segítség	n.
stawm	(meg)hall	vtr.
steftxaw	(meg)vizsgál, ellenőriz	vtr.
stum	majdnem	adv.
sutx	nyomon követ	vtr.
swaw	pillanat	n.
swey	legjobb	adj.
swirä	teremtmény	n.
swizaw	nyíl(vessző)	n.
swok	szent	adj.
swotu	szent hely	n.
syaw	hív, szólít	vin.
syulang	virág	n.
ta	ból/ből, tól/től, felől, irányából (időbeniségre is utalhat más idővel kapcsolatos szavakkal)	adp.
ta'em	fentről, felülről	adv.
tafral	ettől, ezért, emiatt, ebből eredően	adv.
täftxu	sző	vtr.
täftxuyu	takács	n.
takuk	lesújt, (meg)üt, eltalál	vtr.
talioang	viharbölény (pandorai állatfaj)	n.
talun	mert	conj.
taluna	mert	conj.
tam	megteszi; rendben; jó lesz	vin., intj.
tam tam	nyugalom! elég (legyen)! csitulj! semmi baj!	intj.
tangek	fatörzs	n.
tanhì	csillag, biolumineszcens szeplő	n.
taron	vadászik	vtr.
taronyu	vadász	n.
tautral	égi fa (pandorai növényfaj)	n.
taw	ég(bolt)	n.
taweyk	mert, „azon oknál fogva”	conj.
taweyka	mert, „azon oknál fogva”	conj.
tawsìp	éghajó	n.
tawng	lebukik, alámerül, zuhan	vin.
tawtsngal	[?]panopyra, égi csésze (pandorai növényfaj)	n.
Tawtute	ég ember (ember)	prop.n.
te	a teljes nevekben szerepel	part.
tel	kap	vtr.
telem	zsinór	n.
teng	azonos, egyenlő, megegyező	adj.
tengfya	(ugyan)úgy, ahogy/mint...; ahogy, olyanképpen (helyzetből adódó hasonlóság)	conj.
tengkrr	amíg, miközben, mialatt	conj.
teri	ról/ről, vonatkozóan, illetően	adp.
terkup	meghal	vin.
teswotìng	engedélyez	vtr.
teya	tele	adj.
teylu	bogár lárva (pandorai állatfaj)	n.
tewti	gesz. hűha! nahát!	intj.
til	ízület, zsanér	n.
tirea	szellem, szellemiség	n.
tireafya'o	szellemösvény, szellem(i) út (energiaháló)	n.
tireaioang	szellemállat	n.
tireapängkxo	tanácskozik	v.
tì'eyng	válasz, felelet	n.
tìfmetok	próba(tétel)	n.
tìftang	megállás, félbe/megszakítás, hangszalagzárhang	n.
tìfyawìntxu	útmutatás	n.
tìhawnu	védelem	n.
tìkangkem	munka	n.
tìkawng	gonosz(ság)	n.
tìkenong	példa	n.
tìkin	szükség	n.
tìlor	szépség	n.
tìng	ad	vtr.
tìng mikyun	(meg)hallgat	vin.
tìng nari	figyel, szó sz.: szemet ad	vin.
tìngay	igazság	n.
tìpawm	kérdés	n.
tìran	sétál	vin.
tìyawn	szeretet	n.
tìrey	élet	n.
tìrol	dal, ének	n.
tìspxin	betegségi állapot	n.
tìtxur	erő	n.
to	középfokot jelez mint	part.
tok	elfoglal	vtr.
toktor	orvos	n.
tokx	test	n.
tompa	eső	n.
toruk	leonopteryx, végső árny (pandorai állatfaj)	n.
toruk makto	toruk lovas	n.
torukspxam	octoshroom, hatalmas leonopteryx gomba (pandorai növényfaj)	n.
trr	nap (napszak)	n.
trram	tegnap	adv.
tukru	lándzsa	n.
tul	fut	vin.
tung	enged	vtr.
tupe	ki(csoda)?	inter.
tut	folytatás jelző (korábban elhangzott mondat megismétlésére szolgál)	part.
tute	személy	n.
tuté	nő	n.
tutan	férfi	n.
tsa'u	az (dolog)	dem.
tsaheylu	kapcsolat, szinapszis (idegsejtek közt)	n.
tsakem	az (cselekvés)	dem.
tsakrr	akkor	adv.
tsam	háború	n.
tsampongu	háborús csapat	n.
tsamsiyu	harcos	n.
tsap'alute	bocsánatkérés	n.
tsatseng	ott, az(on) a hely(en)	dem., n.
tsatu	ő	dem.
tsawke	nap (égitest)	n.
tsawl	nagy, magas	adj.
tsawlapxangrr	unidelta fa, szó sz. magas, hatalmas gyökér (pandorai növényfaj)	n.
tse'a	lát (szemével)	vtr.
tseng	hely	n.
tsenge	hely	n.
tsengpe	hol?	inter.
tseo	művészet	n.
tskalep	számszeríj, nyílpuska	n.
tsko	íj (fegyver)	n.
tsko swizaw	íj és nyíl	n.
tskxe	kő	n.
tskxekeng	kiképzés, edzés, gyakorlat	n.
tslam	(meg)ért	vtr.
tsleng	hibás, valótlan	adj.
tslolam	Értem! (indulatszó)	intj.
tsmuk	testvér	n.
tsmuktu	testvér (csak emberekre (na’vikra) használva)	n.
tsmukan	fiú testvér	n.
tsmuke	lány testvér	n.
tsnì	hogy, (kötőszó)	sbd.
tsngal	csésze	n.
tspang	öl, gyilkol	vtr.
tsranten	számít, fontos	vin.
tstew	bátor	adj.
tstxo	név	n.
tsun	tud, képes	vim.
tswayon	repül	vin.
tsyal	szárny	n.
tsyo	liszt	n.
tsyorina'wll	cycad, lisztmag növény (pandorai növényfaj)	n.
txan	sok	adj.
txantsan	kitűnő	adj.
txantslusam	bölcs	adj.
txe'lan	szív	n.
txele	lényeg	n.
txen	éber	adj.
txep	tűz	n.
txewk	bunkósbot (fegyver)	n.
txey	megáll	v.
txìm	fenék	n.
txìng	elhagy	vtr.
txll'u	hukatök (pandorai növényfaj)	n.
txo	ha	conj.
txoa	megbocsájtás	n.
txokefyaw	ha nem (különben)...	conj.
txon	este, éjszaka	n.
txopu	félelem	n.
txula	épít	vtr.
txum	méreg	n.
txumpaywll	skorpió bogáncs, mérgező vizinövény (pandorai növényfaj)	n.
txumtsä'wll	feldőlt palack, méreglövellő növény (pandorai növényfaj)	n.
txur	erős (fizikailag/testileg)	adj.
ulte	és (két mondatot köt össze)	conj.
ultxa	találkozó	n.
unil	álom	n.
uniltìrantokx	avatártest (álomjáró test)	n.
uniltìranyu	álomjáró	n.
utral	fa	n.
uvan	játék	n.
uvan si	játszik	vin.
vay	fel	adp.
virä	terjed, szaporodik, sokasodik	v.
vrrtep	démon	n.
vul	faág	n.
way	dal (ősi, szertartásos)	n.
waytelem	dallam	n.
win	gyors	adj.
wìntxu	mutat	vtr.
'ewll	növény	n.
wrrpa	valamin kívüli	n., adv.
wutso	vacsora	n.
ya	levegő	n.
yawne	szeretett	adj.
ye'rìn	hamarosan	adv.
yerik	Hexapéd (Pandórai szervasszerű lény) (pandorai állatfaj)	n.
yey	egyenes	adj.
yìm	(meg)köt	vtr.
yol	hosszú (idő)	adj.
yom	eszik	vtr.
yomhì'ang	kisállat/rovarevő, dakteron (pandorai növényfaj)	n.
yomioang	kehelynövény (pandorai növényfaj)	n.
yomtìng	etet	vin.
yur	mos	vtr.
za'ärìp	húz	vtr.
za'u	jön	vin.
zamunge	hoz	vtr.
zawng	sikolt	vin.
zekwä	ujj	n.
zene	kell	vim.
zìsìt	év	n.
zong	(meg)ment, véd	vtr.
zongtseng	menedék	n.
zoplo	támadás	n.
zusawkrr	jövő	n.
Jakesully	idióta, Toruk Makto	n.
'ärìp	mozgat, (meg)mozdít	vtr.
'awstengyem	összekapcsol, összeilleszt kettő vagy több dolgot (ii)	vtr.
'efu	érez, érzékel	vtr.
'em	főz	vtr.
'eyng	felel, válaszol	v.
'i'a	befejez, lezár (a cselekvés eredményes)	vin.
'ia	eltévelyedik (spirituális értelemben)	vin.
fkxake	viszket	v.
fmal	fenntart	vtr.
frìp	harap	vtr.
ftem	elhalad (vmi. mellett)	vtr.
fwew	keres	vtr.
hangham	nevet, kacag	vin.
vaykrr	amíg, ig	conj.
sngap	megszúr, (meg)csíp	vtr.
hawl	készül(ődik)	vtr.
kä'ärìp	tol, lök, taszít	vtr.
kavuk si	elárul, hátba támad	vin.
kllkä	leereszkedik, alászáll	vin.
latsi	lépést tart	v.
lek	figyelmez, engedelmeskedik	vtr.
len	(meg)történik, bekövetkezik	vin.
lew si	(be)fed, (el)takar	vin.
muntxa si	párosodik, szeretkezik (valakivel)	vin.
näk	iszik	vtr.
nong	követ	vtr.
oeyktìng	megmagyaráz (miért)	vtr.
pate	megérkezik, eljut/elér valahová	v.
piak si	kinyit	vin.
pom	(meg)puszil, (meg)csókol	vtr.
pxor	szétvet, felrobban	vin.
salew	folytat	v.
sar	használ	vtr.
sim	közel van	svin.
sleyku	készít, létrehoz	vtr.
sop	utazik	vin.
spä	ugrik	v.
speng	helyreállít, rendbe hoz	vtr.
spule	(meg)hajt, mozgásba hoz	vtr.
srese'a	megjósol, jövendöl, előre meglát	vtr.
steyki	bosszant, dühít	vtr.
sti	dühöng, bosszankodik	vin.
sto	megtagad, visszautasít, nem hajlandó valamire	vtrm.
sung	hozzátesz, hozzáad	vtr.
syep	csapdába ejt	vtr.
tatep	(el)veszít	vtr.
tätxaw	visszatér	vin.
tem	kiröppen, kivágódik	vin.
tì'awm si	táboroz	vin.
tì'awm	táborhely	n.
tìkangkem si	dolgozik	vin.
tìng tseng	helyet ad	vin.
tìsraw seyki	megsért, megbánt	vtr.
tìsraw	fájdalom	n.
tìsraw si	fáj, fájdalmas(nak lenni)	vin.
toltem	lő	vtr.
tsä'	(ki)lövellni	v.
tsaheyl si	összekapcsolódni vmivel/vkivel, idegi összeköttetést létesíteni	vin.
tsap'alute si	bocsánatot kér	vin.
tsawl slu	nőni	vin.
tsngawvìk	sírni	vin.
tsre'i	dobni	vtr.
tstu si	bezárni	vin.
tsunslu	lehet, szabad	vin.
tsurokx	pihenni	vin.
tungzup	elejt (ii)	vtr.
wem	harcolni, küzdeni	vin.
win säpi	sietni	vin.
win si	gyorsítani, siettetni, sietni	vin.
yän	odaerősít, leköt(öz)	vtr.
yem	rak, helyez	vtr.
zenke	tilos, nem szabad	vim.
zup	(le)esni	vin.
nekll	lefelé	adv.
srung si	segít(séget nyújt)	vin.
txopu si	félni	vin.
fkip	fent között(e)	adp.
io	fent, felül, felett	adp.
kxamlä	át, keresztül (vmi közepén át)	adp.
lok	közel(ében)	adp.
maw	időben utána, követően	adp.
mìkam	között(e)	adp.
nemfa	bele, befelé, belülre, belsejébe	adp.
pxaw	körül(ötte)	adp.
pxel	ként, akként/úgy..., mint/ahogy	adp.
sìn	rá, rajta	adp.
takip	közül(ről)	adp.
uo	mögött	adp.
luke	nélkül(e)	adp.
tafkip	fentről valami(k) közül	adp.
ro	nál/nél	adp.
sre	korábban, megelőzőleg	adp.
wä	ellen (pl: harcolni vki ellen)	adp.
fäpa	tető, csúcs	n.
alìm	messze, távol	adv.
aylaru	a többieknek	pn.
kxu	baj, ártalom	n.
eltu lefngap	számítógép ('fém agy')	n.
kì'ong	lassú	adj.
säfpìl	gondolat, ötlet	n.
kefyak	ugye? igaze? nem igaz?	part.
prrwll	moha	n.
pängkxoyu lekoren	ügyvéd, jogász	n.
pamrel	írás	n.
pamrel si	ír	vin.
furia	annak, hogy (alárendelő mellékmondat kötőszava)	pn., sbd.
fratseng	mindenütt, mindenhol	adv.
fratrr	naponta, minden nap	adv.
frato	, leg mindennél olyanabb (toldalékként viselkedik)	part.
trray	holnap	adv.
kea	nem (főnév előtt)	adj.
ngian	bármily, akármennyire	adv.
skepek	formális, hivatalos	adj.
hufwa	bár, ugyanakkor, ámbátor	conj.
tup	helyett, inkább mint...	conj.
'uo	valami	pn.
tuteo	valaki	pn.
tsengo	valahol	pn.
holpxaype	hány darab?	inter.
hìm	kevés, csekély	adj.
hìmtxampe	mennyi?	inter.
hìmtxan	összeg, mennyiség	n.
pìmtxan	mennyi?	inter.
lì'upe	Mi? (Mit mondott?)	inter.
pelì'u	milyen szó? hogy mondta?	inter.
ultxarun	összefutni, véletlenül találkozni	vtr.
ultxa si	találkozni (szándékosan) ( val, vel használatával)	vin.
rangal	kíván, óhajt	vin.
nìrangal	bárcsak! (kívánság; a tényekkel szemben, befejezett vagy folyamatos kötőmóddal)	adv.
txepvi	szikra	n.
nitram	jókedvű, vidám	adj.
fewi	üldöz, hajszol	vtr.
stä'nì	elkap	vtr.
sran	aha, ja, oké	part., intj.
weyn	rajzol, illusztrál	vtr.
fìtrr	ma	adv.
rusey	élő, élőlény	adj., n.
vitra	lélek	n.
nìzawnong	biztonságban, biztonságosan	adv.
ftawnemkrr	múlt	n.
txal	hát (testrész)	n.
tsìng	négy, 4	num.
mrr	öt, 5	num.
pukap	hat, 6	num.
kinä	hét, 7	num.
vol	nyolc, 8	num.
zam	hatvannégy, 64	num.
tìoeyktìng	magyarázat	n.
lesar	hasznos	adj.
tse	nos (bevezető szó társalgásnál)	part.
skxom	esély, lehetőség	n.
fkxen	zöldség (mint étel)	n.
syä'ä	keserű	adj.
yemfpay si	merít (folyadékba)	vin.
yemfpay	bemártás, merítés (folyadékba)	n.
keng	még (fokozószó)	adv.
'awlo	egyszer (nem többször)	adv.
melo	kétszer	adv.
heyn	ül	vin.
nìpxim	felegyenesedve, egyenesen	adv.
pxim	egyenes, felegyenesedett	adj.
tuvon	hajlik	v.
nìfya'o	módjára, módon, mód	adv.
letrrtrr	mindennapos, hétköznapi	adj.
nì'eoio	ünnepélyesen	adv.
'eoio	ünnepélyes	adj.
rìk	levél (növényi rész)	n.
lerìk	leveles, levélborította	adj.
pa'o	oldal(a)	n.
kllpa	alj(a), fenék	n.
mìfa	belseje, belül, odabent	n., adv.
nefä	felfelé	adv.
zapxì	elülső rész vagy darab	n.
käpxì	hátsó (fél vagy rész)	n.
käsatseng	odakint	adv.
ftxey	(e)... vagy nem, (e)... vagy sem	conj.
ngaytxoa	bocs, szánombánom, sajnos, sajna, az én saram (megbánás vagy vétkesség beismerése)	intj.
flew	torok	n.
kxa	száj	n.
nikre	haj	n.
pewn	nyak	n.
re'o	fej	n.
sre'	fog (testrész)	n.
tsuksìm	áll (testrész)	n.
key	arc, orca, ábrázat	n.
puk	könyv	n.
ngäng	gyomor	n.
ta'leng	bőr	n.
tsyokx	kéz	n.
reypay	vér	n.
tsopì	tüdő	n.
venu	lábfej	n.
venzek	lábujj	n.
ramunong	kút	n.
payfya	folyam, patak, vízfolyás	n.
pxawpa	kerület, határ, perem	n.
txampay	tenger, óceán	n.
'ora	tó	n.
ekxan	barikád, akadály	n.
tsim	forrás (átvitt értelemben)	n.
tsray	falu	n.
txayo	mező, nyílt terep, síkság	n.
ukxo	száraz	adj.
wew	hideg	adj.
fìtxon	ma este	adv., n.
txonam	Múlt éjjel	adv.
txonay	holnap éjjel	adv.
sekrr	jelen	n.
vur	történet	n.
tìpängkxo	beszélgetés, megbeszélés	n.
tìsrese'a	jóslat	n.
nawmtu	hős, nagy ember	n.
txantstew	hős	n.
syuve	étel, ennivaló (gyűjtőnév, nincs többesszáma)	n.
tsngan	hús	n.
tstal	kés	n.
tete	tompa, életlen	adj.
lew	fedő, valaminek a teteje	n.
'opin	szín	n.
leNa'vi	a na’vikkal mint néppel kapcsolatos	adj.
nìNa'vi	mint a na’vik, na’viul	adv.
hapxìtu	(csoport)tag	n.
'Rrta	Föld	prop.n.
fwäkìwll	imádkozó sáska (pandorai állatfaj)	n.
hì'ang	rovar	n.
payoang	hal	n.
yayo	madár	n.
zize'	pokoli tűzdarázs (pandorai állatfaj)	n.
kemlì'u	ige	n.
tstxolì'u	főnév	n.
ftär	bal (bal oldali)	adj.
skien	jobb (nem bal)	adj.
'änsyem	teljes, egész	adj.
wotx	teljesség, egész	n.
mowan	kellemes, élvezhető (fizikailag, szexuálisan)	adj.
vä'	kellemetlen, undorító	adj.
tatlam	látszólag	adv.
keteng	más	adj.
numtseng	iskola	n.
skxakep	valószínű, valószínűleg	adj., adv.
tìprrte'	öröm	n.
kaw'it	egyáltalán, egyáltalán nem (lásd ke...kaw'it egyáltalán nem kifejezésekben)	adv.
nìlkeftang	folyamatosan, megállás nélkül	adv.
tì'i'avay	a végsőkig	adv.
'awm	tábor	n.
tìska'a	pusztítás	n.
tìsop	utazás	n.
wempongu	szakasz, katonai egység, csapat	n.
asim	közelben, karnyújtásnyira	adv.
klltseng	helyzet	n.
kxutu	ellenség	n.
mekre	ellátmány, utánpótlás	n.
tìhawl	előkészületek, terv	n.
tìkan	cél(kitűzés)	n.
tìpähem	érkezés	n.
numeyu	tanuló, diák	n.
soaia	család (rendhagyó birtokos esete: soaiä)	n.
tìmuntxa	párzás, házasság	n.
yawnetu	szeretett személy	n.
yawntu	szeretett személy	n.
kakrel	vak	adj.
kanu	eszes, okos, értelmes	adj.
koak	öreg, idős, hajlott korú	adj.
lekye'ung	bolond, őrült, őrületes	adj.
me'em	harmonikus, egybehangzó	adj.
txanew	falánk, mohó	adj.
txantur	erőteljes	adj.
tì'awpo	egyénieskedés, önzés	n.
tì'eylan	barátság	n.
fkay	utálatos	adj.
keltsun	lehetetlen	adj.
kxuke	biztonságos	adj.
lehawng	túlzó, túlzásba vitt	adj.
hawng	(kötött morféma) túlzás	n.
lekin	szükséges, szükségszerű	adj.
stxong	különös, szokatlan, ismeretlen	adj.
syen	végső, utolsó	adj.
kavuk	hűtlenség, árulás	n.
fpìlfya	gondolkodásmód	n.
syay	sors	n.
tìfnu	csend, némaság	n.
tìngop	alkotás elvont fogalma	n.
tìpe'un	döntés	n.
kxitx	halál	n.
trr'awve	vasárnap	n.
trrmuve	hétfő	n.
trrpxeyve	kedd	n.
trrtsìve	szerda	n.
trrmrrve	csütörtök	n.
trrpuve	péntek	n.
trrkive	szombat	n.
'ango	halk (hang)	adj.
kxayl	magas	adj.
rey'eng	az élet egyensúlya	n.
tìme'em	harmónia (általános értelemben)	n.
fnel	fajta	n.
fnepe	miféle?	inter.
pefnel	miféle?	inter.
zerok	emlékezni	vtr.
tswa'	elfelejt	vtr.
tì'efu	érzelem	n.
maweypey	türelmes(nek lenni)(ii)	svin.
tìmweypey	türelem	n.
lemweypey	türelmes	adj.
nìmweypey	türelmesen	adv.
tsakrrvay	addig, azalatt	adv.
ohakx	éhes	adj.
tìohakx	éhség	n.
tsyosyu	lisztből készült étel	n.
vey	állati eredetű táplálék (étel), hús	n.
trrpeve	Milyen nap?	inter.
pxiswawam	egy pillanattal ezelőtt	adv.
pxiset	éppen most, ebben a pillanatban	adv.
pxiswaway	egy pillanat múlva, azonnal	adv.
pxiye'rìn	mindjárt (nem olyan hamar, mint pxiswaway)	adv.
pxisre	éppen előtte	adp.
pximaw	rögtön, egyből utána	adp.
sok	friss, új keletű	adj.
'awlie	egyszer (a múltban)	adv.
tìkxey	tévedés, hiba	n.
tìkxey si	elront, hibát vét, rosszat tesz	vin.
tìyawr	helyesség	n.
tìketeng	különbség	n.
fpomtokx	egészség (fizikai)	n.
lefpomtokx	egészséges (fizikailag)	adj.
kelfpomtokx	egészségtelen (fizikailag)	adj.
keftxo	boldogtalan, szomorú, 'Milyen szomorú!'	adj., intj.
nìkeftxo	szomorúan	adv.
sraw	fájdalmas	adj.
txampxì	többség, legtöbb, nagyrészt	n.
vurvi	összegzés, áttekintés	n.
sänumvi	lecke, tanóra	n.
letam	megfelelő	adj.
letsranten	fontos	adj.
nìswey	optimálisan, legjobban	adv.
nìpxi	különösen, nyomatékkal, féélreérthetetlenül	adv.
wok	hangos	adj.
spuwin	régi , korábbi	adj.
nì'eyng	vissza, válasz képpen	adv.
nìkanu	intelligensen, okosan	adv.
nìlaw	tisztán, világosan	adv.
tìsti	düh	n.
tìtxanew	falánkság, mohóság	n.
tìftxey	választás	n.
tìkanu	ész	n.
tìlam	megjelenés, kinézet	n.
tìtslam	értelem, intelligencia	n.
tìtxula	építmény	n.
hewne	puha (tárgy)	adj.
tìm	alacsony	adj.
laro	tiszta	adj.
tsewtx	koszos	adj.
lefngap	fém(ből készült)	adj.
txa'	kemény	adj.
fwel	törött	adj.
etrìp	előnyös, kedvező	adj.
piak	nyitott, tiszta (pl.:felhőtlen ég)	adj.
tstu	zárt, borús (pl.: felhős ég)	adj.
kxll si	lerohan, támad	vin.
tsaw	az (mutatónévmás)	dem., pn.
tsalsungay	mindazonáltal	adv.
oìsss	dühödt mordulás, 'vigyázz!'	intj.
saa	fenyegető kiáltás	intj.
sau	felkiáltás erőlködés közben, uff! hórukk!	intj.
tsahey	figyelmeztetést vagy csalódottságot kifejező szó 'a francba!'	intj.
wiya	figyelmeztető vagy csalódottságot kifejező szó, 'francba!'	intj.
ìley	harci kiáltás	intj.
vawm	sötét	adj.
tìvawm	sötétség	n.
polpxay	hány (darab)?	inter.
ke'aw	elosztott, darabolt	adj.
nìsti	dühösen, mérgesen	adv.
teyr	fehér	adj.
layon	fekete	adj.
pänu	ígéret	n.
kew	nulla, 0	num.
'eyt	a 8as jele (nem az értéke!) (pl. telefonszámnál használható)	n.
nayn	a 9es jele (nem az értéke!) (pl. telefonszámnál használható)	n.
trr'ong	hajnal, napkelte	n.
trr'ongmaw	napkelte után	n.
rewon	reggel	n.
srekamtrr	délelőtt	n.
kxamtrr	dél (napszak)	n.
kxamtrrmaw	kora délután	n.
ha'ngir	délután	n.
kaym	este (alkonyat előtt), késő délután	n.
sreton'ong	alkony, este naplemente előtt	n.
txon'ong	naplemente, napszállta	n.
txon'ongmaw	alkony, sötétedés előtti időszak, naplemente után	n.
srekamtxon	éjfél előtt	n.
kxamtxon	éjfél	n.
kxamtxomaw	éjfél után	n.
sresrr'ong	hajnal előtt	n.
wou	„állat”, „sirály”, „király”. (slang)	svin.
tsyìräfì	zsiráf	n.
tsawa	hogy (alárendelő tagmondat jelző)	pn., sbd.
tsata	hogy (alárendelő tagmondat jelző)	pn., sbd.
tsaria	hogy (alárendelő tagmondat jelző)	pn., sbd.
alo	eset, alkalom, ismételten előforduló cselekvések egyike	n.
fralo	minden alkalommal, minden esetben, minden időben	adv.
nìmwey	nyugodtan, békésen	adv.
ku'up	nehéz, súlyos (fizikai értelemben)	adj.
syo	könnyű (fizikai értelemben)	adj.
hay	következő	adj.
ham	előző (korábbi)	adj.
matsa	matsa, crackers	n.
hametsì	kovászos kenyér	n.
tìkangkemvi	feladat, kijelölt/egységnyi munka	n.
nì'i'a	végül, végre	adv.
nìsyen	utolsóként	adv.
pìlok	blog	n.
tsulfätu	mester	n.
tsulfä	hozzáértés, alapos ismeret	n.
tsulfä si	alaposan elsajátít	vin.
numtsengvi	osztályterem	n.
rofa	mentén	adp.
pum	tulajdon, birtokolt dolog („ál”névmás birtokos esetű főnevekhez és névmásokhoz)	pn.
Yuesey	USA	prop.n.
teya si	tölt (a megtöltött dolog részes esetben)	vin.
alunta	(azért) mert	conj.
nìprrte'	örömmel, üdvözölve (zola'u–val használva)	adv.
sngä'iyu	kezdő	n.
srekrr	korábban, már	adv.
ayu	dolgok	n.
tsafya	úgy, olyan módon	adv.
muve	második (sorszámnév)	adj.
pxeyve	harmadik (sorszámnév)	adj.
tsìve	negyedik (sorszámnév)	adj.
mrrve	ötödik (sorszámnév)	adj.
puve	hatodik (sorszámnév)	adj.
kive	hetedik (sorszámnév)	adj.
volve	nyolcadik	adj.
tsyänel	TV csatorna	n.
trrtxon	napéj változás Pandorán, egy pandorai nap	n.
au	felkiáltás	intj.
pängkxoyu	beszélgetőtárs, társalkodó	n.
lekoren	szabályos	adj.
prrkxentrrkrr	„nappali örömteli füstölgés”, dohányzás (na'vi idióma)	n.
tìftia	tanulás	n.
tìftia kifkeyä	tudomány, természettudomány	n.
pxir	sör	n.
eanean	cheadle, lágyszárú növény (pandorai növényfaj)	n.
'ele'wll	tüskés mancs, kaktusz (pandorai növényfaj)	n.
tstxa'a	canalyd	n.
pa'liwll	páncélos ló kancsónövény (pandorai növényfaj)	n.
anìheyu	fibonacci, kék spirál növény (pandorai növényfaj)	n.
tompawll	geode, esőnövény (pandorai növényfaj)	n.
pxiwll	remeterügy növény (pandorai növényfaj)	n.
syeptute	hyneman, emberfogó (pandorai növényfaj)	n.
kllpxiwll	oroszlánbogyó (pandorai növényfaj)	n.
smaoe	falanxia, nagyon tüskés növény (pandorai növényfaj)	n.
'ä'o	kancsóka	n.
mulpxar	kakasfej növény (pandorai növényfaj)	n.
flefle	Sol öröme, magnetotrophic (pandorai növényfaj)	n.
kxaylte	cillaphant (pandorai növényfaj)	n.
fkxakewll	viszkető növény (pandorai növényfaj)	n.
tìhawnuwll	spártai, menedéknövény (pandorai növényfaj)	n.
pxorna'lor	szári, gyönyörű robbanó mag növény (pandorai növényfaj)	n.
pxayzekwä	tüskés korbács (pandorai növényfaj)	n.
mìnyu	csavart liliom (pandorai növényfaj)	n.
mìnyu	turner	n.
väfewll	százlábú, rossz szagú növény (pandorai növényfaj)	n.
sngukx	féregnövény (pandorai növényfaj)	n.
rawp	hólyag polip (pandorai állatfaj)	n.
'ampirikx	levélkancsóka (érintésre mozgó) (pandorai növényfaj)	n.
apxangrr	delta fa, szó sz. nagy gyökér (pandorai növényfaj)	n.
värumut	érgubó (pandorai növényfaj)	n.
keyawr	helytelen, téves, nem helyes	adj.
lehrrap	veszélyes	adj.
tìtxen	éberség, ébrenlét	n.
hìrumwll	puffer növény (pandorai növényfaj)	n.
fwäkì	sáska	n.
fratxon	minden éjjel	adv.
hìkrr	másodperc, nagyon rövid idő	n.
mawkrr	után, utána	adv.
ngeyn	fáradt	adj.
ngopyu	alkotó	n.
nìk'ong	lassan	adv.
pamtseotu	zenész	n.
sat	az	pn.
tsal	az (tárgyas esetben alanyként)	pn.
tsat	azt ( tárgyként)	pn.
tsawlhì'	méret	n.
lì'fyavi	kifejezés, nyelvi elem	n.
nafì'u	olyan, mint ez a dolog	adj.
lì'fyaolo'	nyelvcsoport, nyelvhasználók	n.
puktsyìp	pamflet, könyvecske	n.
utraltsyìp	bokor	n.
säspxintsyìp	kisebb betegség, gyengélkedés	n.
'itetsyìp	kislány (kedveskedő kifejezés)	n.
sa'nutsyìp	anyuka (fiatal lányokra)	n.
kem si	csinál	vin.
tswin	copf, idegköteg	n.
tswintsyìp	copfocska	n.
taronyutsyìp	vadászocska	n.
oetsyìp	csekélységem	pn.
ngatsyìp	kicsi te, csekélységed	pn.
atanvi	fénysugár	n.
txeptsyìp	tüzecske	n.
tìkusar	tanítás (cselekvés)	n.
tìyusom	evés (cselekvés)	n.
tìtusaron	vadászás	n.
tìpängkxotsyìp	csevej	n.
hayalo	legközelebb	adv.
hamalo	múltkor	adv.
tstunwi	kedves, figyelmes,tapintatos	adj.
seykxel	erős (érzelmileg, lelkileg, nem fizikailag), magabiztos	adj.
fuke	vagy nem	conj.
'a'aw	egy kevés, néhány	adj.
'okrol	történelem (ősi)	n.
'okvur	történelem (nem ősi)	n.
alu	azaz hogy, más szóval	conj.
fnawe'	gyáva	adj.
fnawe'tu	gyáva	n.
ftxìlor	finom, jó ízű	adj.
ftxìvä'	rossz ízű	adj.
fyeyn	érett, fejlett, felnőtt	adj.
fyeyntu	felnőtt személy	n.
tìfyeyn	érettség, fejlettség, beteljesülés	n.
hawngkrr	későn	adv.
lehawngkrr	késői	adj.
leye'krr	korai	adj.
hek	furcsának, különösnek, idegennek, váratlannak lenni	vin.
nìhek	furcsa módon, különös módon	adv.
ki	de inkább, de helyette	conj.
nìfyeyntu	felnőtt módra, éretten	adv.
nì'eveng	gyerek módra, éretlenül	adv.
lìng	levegőben úszik, lebeg	vin.
ram	hegy	n.
muntxatu	hitves, házastárs	n.
muntxatan	férj, férfi hitves	n.
muntxate	feleség, női hitves	n.
netrìp	szerencsésen, boldogan	adv.
newomum	kíváncsi(nak lenni), tudni akar	svin.
lenomum	kíváncs	adj.
tìnomum	kíváncsiság	n.
ngäzìk	bonyolult, nehéz	adj.
tìngäzìk	nehézség, probléma	n.
nìsung	emellett, ráadásul, továbbá	adv.
reng	sekély (fizikailag)	adj.
rolun	Heuréka! Rájöttem!	intj.
sa'sem	szülő vagy szülőpár	n.
smar	préda, zsákmány	n.
starsìm	összeszed, gyűjt	vtr.
sunu	megnyerő(nek) vagy szeretetre méltó(nak lenni)	vin.
syayvi	szerencse, esély	n.
nìsyayvi	sorsszerűen, véletlenül	adv.
tolel	Heureka! Megvan! Értem!	intj.
txukx	mély (fizikailag)	adj.
ve'kì	utál, gyűlöl	vtr.
tìve'kì	gyűlölet	n.
yaymak	buta, tudatlan	adj.
ye'krr	korán	adv.
zìsìkrr	évszak	n.
zo	jól lenni, rendben lenni, rendben működni	svin.
zoslu	(meg)gyógyul, javul	vin.
zeyko	(meg)gyógyít, javít	vtr.
frawzo	Minden rendben, minden OK	intj.
kemlì'uvi	infixum	n.
irayo si	megköszön	vin.
lefkrr	időszerű/jelenlegi	adj.
lì'upam	hangsúly, kiejtés	n.
natkenong	például	conj.
eltur tìtxen si	érdekes(nek lenni)	vin.
pxelo	háromszor	adv.
pamrelfya	betűzés (helyesírás)	n.
law si	világossá tesz	vin.
tìsung	kiegészítés, utóirat (P.S.)	n.
naer	ital, innivaló	n.
atxkxerel	térkép	n.
nìtengfya	mint, ugyanúgy (mint) (hasonló cselekedet)	adv.
tun	piros, narancssárga	adj.
'om	lila	adj.
neyn	világos színek	adj.
ngul	szürke	adj.
tumpin	piros szín	n.
eampin	kék/zöld szín	n.
rimpin	sárga szín	n.
'ompin	lila szín	n.
layompin	fekete szín	n.
teyrpin	fehér szín	n.
vawmpin	sötét szín	n.
neympin	világos szín	n.
ngulpin	szürke szín	n.
pil	arccsík	n.
ta'lengean	na'vi bőrkék	adj.
rìkean	levélzöld	adj.
kllvawm	barna	adj.
'evan	fiú (köznapi)	n.
'eve	lány (köznapi)	n.
'evengan	fiú	n.
'evenge	lány	n.
fkio	tetrapteron (pandorai állatfaj)	n.
kenten	legyezőgyík	n.
nìwä	ellenkezőleg, ellentétesen	adv.
pìwopx	felhő	n.
ramtsyìp	domb	n.
syaksyuk	prolemuris (pandorai állatfaj)	n.
tor	utolsó, végső, befejező	adj.
txärem	csont	n.
uk	árny(ék)	n.
yapay	pára, köd, gőz	n.
tìspe'e	zsákmány	n.
tìftxavang	szenvedély	n.
tìtstunwi	kedvesség	n.
stxeli	ajándék	n.
ngrrpongu	néprétegek megmozdulása	n.
smon	ismerni	vin.
lawk	értekezik, beszél valamiről, oda vonatkozót mond	vtr.
hìtxoa	Elnézést!	intj.
mäkxu	megszakít, félbeszakít, kizökkent	vtr.
hultstxem	akadályoz	vtr.
mok	javasol	vtr.
muwìntxu	bemutat, előad	vtr.
kan'ìn	koncentrál valamire, specializálódik, különösen érdeklődik	vtr.
tìwusem	küzdelem	n.
nì'eng	egyformán, egy szinten	adv.
Pari	Párizs	prop.n.
tì'ong	virágzás, kinyílás	n.
tìmok	javaslat	n.
tì'em	a főzés művészete	n.
leyn	ismétel, újra csinál	vtr.
päsketpol	basketball	n.
nìFranse	francia, franciául	adv.
nìToitsye	német, németül	adv.
nìno	részletesen, alaposan	adv.
hìno	finom, részletes, precíz, bonyolult (dolog)	adj.
leno	alapos, részletességre törekvő (személy)	adj.
tìno	alaposság, részletesség	n.
'ongokx	születik	vin.
nokx	szül (valakit)	vtr.
nìtrrtrr	napi szinten, rendszeresen	adv.
tìn	elfoglaltságot adó cselekvés	n.
txin	fő, elsődleges	adj.
txintìn	foglalkozás, elsődleges szerep a társadalomban	n.
'emyu	szakács	n.
vewng	vigyáz, gondoskodik, felelős	vtr.
kaltxì si	köszön(t), üdvözöl	vin.
sopyu	utazó	n.
fula	azt, hogy (alárendelt tagmondatot jelez)	pn., sbd.
tskxekeng si	gyakorol, edz	vin.
way si	dalol	vin.
swawtsyìp	kis pillanat, másodperc	n.
käteng	időt tölteni, „lógni” valakivel	vin.
'ìn	elfoglalt, tevékeny	svin.
Sweriye	Svédország	prop.n.
nìfkrr	mostanában, jelenleg	adv.
sulìn	elfoglalt(nak lenni) (pozitív értelemben), elmélyed valamiben, amit különösen kellemesnek talál	svin.
vrrìn	elfoglalt(nak lenni) (negatív értelemben): „nyakig ül a munkában”	svin.
tìk'ìn	szabadidő, teendők hiánya	n.
säsulìn	hobby, örömet szerző tevékenység	n.
'o'	mókás, izgalmas	adj.
Europa	Európa	prop.n.
skxaypxe	Skype	n.
pxorpam	„ejective” mássalhangzó (kx,tx,px)	n.
tì'o'	móka, izgalom	n.
nì'o'	élvezetes módon, élvezetesen	adv.
fnan	jó valamiben	vtr.
wätx	rossz valamiben	vtr.
tìsom	hő	n.
tìwew	hideg	n.
tìlen	esemény, történés	n.
nìnäk	ivás útján	adv.
nìhay	következően	adv.
sayrìp	jóképű, helyes	adj.
letokx	testi, fizikai	adj.
säzärìp	kantár, kötőfék	n.
ìpxa	páfrány	n.
tìhawnu si	véd	vin.
sno	a sajátja  (visszaható)	pn.
kìte'e si	szolgál	vin.
var	valamilyen állapotban marad, folytat egy cselekvést	vim.
nìftxan	úgy, annyira	adv.
Yeysu	Jézus	prop.n.
lelì'fya	nyelvet illető, nyelvi	adj.
takrra	… óta (időben) másik alakja 	conj.
akrrta	… óta (időben)	conj.
few	keresztül, át az ellenkező oldalra	adp.
fewtusok	ellentkező, az ellenkező oldalon	adj.
sla'tsu	leír (jellemez)	vtr.
tìsla'tsu	leírás	n.
'en	tipp, találgatás, gyanú, megérzés	n.
'en si	találgat	vin.
le'en	elméleti, intuitív	adj.
nì'en	találgatva, megérzés alapján cselekedve	adv.
sä'o	eszköz, szerszám	n.
pamtseo si	zenél (fa a hangszer neve előtt)	vin.
väng	szomjas	adj.
tìväng	szomjúság	n.
sngum	aggodalom	n.
nìsngum	aggódva, bosszúsan	adv.
yayayr	zűrzavar	n.
wäte	vitatkozik, veszekszik	vtr.
tìwäte	vita, veszekedés	n.
säwäte	a vita tárgya, a szóváltás oka, a vitatott dolog	n.
lewäte	kötekedő, okoskodó (személy)	adj.
nìwäte	kötekedve, húzódozva	adv.
li	már	adv.
lisre	mire, amíg, addigra	adp.
ronsrelngop	elképzel, felidéz  (eredete: ronsem elme, rel kép, ngop alkot, köznapi kiejtése [Ron.sREw.Nop] )	vtr.
ronsrel	elképzelt dolog	n.
tìronsrel	képzelet	n.
txanatan	fényes, élénk	adj.
leronsrel	képzeletbeli	adj.
nìronsrel	képzeletben, képzelet útján	adv.
srefey	elvár, számít valamire	vtr., vin.
mawl	(egy) fél	n.
pan	(egy) harmad	n.
wan	elrejt	vtr.
nìwan	titokban, rejtve, rejtőzve	adv.
tìwan	összezavarrás, álcázás	n.
letwan	cseles, trükkös (személy)	adj.
slele	úszik	vin.
nìslele	úszva	adv.
tìtaron	vadászás (általában)	n.
ìì	ööö, izé	intj.
tsukyom	ehető	adj.
ketsuktswa'	felejthetetlen	adj.
tsuktswa'	felejthető	adj.
yafkeyk	időjárás	n.
fkeytok	létezik	vin.
tìfkeytok	állapot, körülmény, helyzet	n.
tompameyp	szitáló eső	n.
tskxaytsyìp	jégeső	n.
tskxepay	jég	n.
herwì	hó	n.
tomperwì	havaseső	n.
txanfwerwì	hóvihar	n.
hermeyp	hózápor	n.
hertxayo	hómező	n.
ìlva	pehely, csepp, szilánk	n.
txepìva	hamu, parázs	n.
herwìva	hópehely	n.
payìva	vízcsepp	n.
tompìva	esőcsepp	n.
kintrr	egy hét	n.
mrrtrr	ötnapos munkahét	n.
muntrr	hétvége	n.
kintrram	a múlt (előző) hét	n.
kintrray	a jövö (következő) hét	n.
muntrram	múlt hétvége	n.
muntrray	jövő hétvége	n.
vospxì	hónap	n.
vospxìam	múlt hónap	n.
vospxìay	jövő hónap	n.
sweylu	kellene	v.
ye	(meg)elégedett, hiánytalan, tele	adj.
hasey si	befejez, elvégez	vin.
seysonìltsan	Szép munka! (eredete: hasey soli nìltsan jól elvégzett)	intj.
yehakx	jóllakott, tele	adj.
yeväng	szomját csillapított, szomját oltott	adj.
somwew	hőmérséklet	n.
pup	rövid (fizikai hosszúság)	adj.
ngimpup	hosszúság	n.
pesomwew	Milyen hőmérsékletű?	inter.
somwewpe	Milyen hőmérsékletű? (gyakoribb)	inter.
txawew	nagyon hideg	adj.
wur	hűvös, hideg	adj.
tsyafe	enyhe, mérsékelt, kellemes	adj.
sang	meleg	adj.
txasom	nagyon forró	adj.
leyapay	ködös, homályos	adj.
lepwopx	felhős	adj.
nìhol	kicsit, kissé	adv.
nìpxay	nagyon, nagyban	adv.
paynga'	nedves, nyirkos, párás	adj.
meuianga'	becsületes, tiszteletreméltó	adj.
txumnga'	mérgező	adj.
'akra	talaj (termő)	n.
hufwetsyìp	szellő, enyhe szél	n.
nìlam	látszólag	adv.
nìli	előre is, előzetesen	adv.
nìfrakrr	mint mindig	adv.
am'a	kétség	n.
nga'	tartalmaz	vtr.
tìftang si	megállít	vin.
may'	(ki)próbál, értékel, ellenőriz	vtrm.
yora'	nyer	vtr.
snaytx	veszít	vtr.
tìyora'	győzelem, nyerés	n.
tìsnaytx	vereség, veszteség	n.
'otxang	hangszer (általános)	n.
skxir	seb	n.
leskxir	sebesült	adj.
skxir si	megsebesít	vin.
skxirtsyìp	vágás, horzsolás, kisebb seb	n.
sloan	önt, folyik	vtr.
emrey	túlél	vin.
temrey	túlélés	n.
lemrey	túlélő (pl. olyan csoport tagjai, akik közül meghalt néhány)	adj.
nemrey	Úgy, mintha kockán forogna az élete	adv.,intj.
wawe	jelentés, fontosság, jelentősség	n.
txanwawe	személyesen fontos, jelentős	adj.
nìwawe	értelmesen, jelentősen	adv.
keyrel	arckifejezés	n.
fwampop	tapirus	n.
säplltxe	állítás	n.
säplltxevi	megjegyzés	n.
kawtseng	sehol	adv.
tsapo	az (csak személyekre)	pn.
fwefwi	fütyül	vin.
'etnaw	váll	n.
pllngay	elismer	vin.
kawngsar	kihasznál	vtr.
lom	hiányzó, hiányolt (mint egy távollévő ember, akinek vágynak a jelenlétére)	adj.
koaktan	öregember (férfi)	n.
koakte	öregasszony	n.
koaktu	öreg ember/öreg személy	n.
lomtu	hiányzó/hiányolt személy	n.
fe'	rossz	adj.
nìfe'	rosszul	adv.
wätu	ellenfél	n.
fekem	baleset	n.
hawtsyìp	szunyókálás	n.
uran	hajó	n.
ftxozä si	ünnepel	vin.
kekem	tett/cselekvés nélkül	pn., adv.
pxen	funkcionális öltözék (része)	n.
tewng	ágyékkötő	n.
raspu'	lábszárvédő (harcban használatos)	n.
hawnven	cipő	n.
hawntsyokx	kesztyű	n.
hawre'	kalap	n.
ioi	dísz, vagy ünnepi felszerelés/ruházat (része)	n.
nìlun	természetesen, logikusan, értelemszerűen	adv.
'ali'ä	gallér/nyaklánc	n.
'are	ponchó, köpeny, kendő	n.
fkxile	mellkast takaró nyaklánc	n.
masat	mellvért (páncél)	n.
nikroi	hajdísz	n.
pxawpxun	karkötő, karszalag	n.
renten	védőszemüveg, (rovarszárnyból készült, fából faragott, stb.)	n.
tsamopin	harci festék/festés	n.
tsang	piercing/testékszer	n.
miktsang	fülbevaló	n.
ontsang	orrgyűrű	n.
yemstokx	felvesz (ruhát)	vtr.
ioi si	díszít	vin.
'aku	eltávolít, elvisz, levesz	vtr.
le'aw	egyetlen	adj.
mawkrra	utána (időben)	conj.
akrrmaw	utána (időben)	conj.
Toitslan	Németország	prop.n.
Toitsye	német (nyelv)	adj.
lukpen	ruha nélküli, meztelen	adj.
fmawnta	azok a hírek	n.
vin	kér	vtr.
mìftxele	ebben a tekintetben, ezzel kapcsolatban	adv.
zìma'uyu	újonc, valaki aki most lépett színre	n.
nìvingkap	apropó, mellesleg, jut eszembe	adv.
txankrr	régóta	adv.
vingkap	eszébe jut, ``beugrik"	vtr.
tìomum	tudás	n.
tinan	olvasás	n.
ninan	olvasva	adv.
tsmìm	állatnyom, csapás (állaté vagy személyé)	n.
inan	olvas (e.g. az erdőt), érzékelés útján tudást szerez valamiről	vtr.
'ä'	Hoppá!	intj.
teynga	az a válasz	n.
teyngla	az a válasz (jelölt alany)	n.
teyngta	az a válasz (tárgyeset)	n.
fayluta	ezek a szavak	n.
stxenu	ajánlat	n.
tìtstew	bátorság, merészség	n.
tìtstewnga'	bátor, merész	adj.
stxenutìng	ajánl	vtr.
tsyär	elutasít	vtr.
tìtsyär	elutasítás	n.
mll'an	elfogad	vtr.
tìmll'an	elfogadás	n.
kam	...előtt (időben)	adp.
kay	mostantól (a jövőben)	adp.
'awnìm	elkerül	vtr.
steng	hasonló	adj.
nìsteng	hasonlóan	adv.
nim	szégyenlős, félénk	adj.
srätx	bosszant, zavar	vtr.
säsrätx	bosszúság	n.
rì'ìr	tükörkép	n.
rì'ìr si	tükröz, utánoz	vin.
tsìsyì	suttog	vin.
nìwok	hangosan	adv.
sätsìsyì	suttogás	n.
nìtsìsyì	suttogva	adv.
nìfwefwi	fütyülve, fütyörészve	adv.
lawr	dal, dallam	n.
tìng lawr	szöveg nélkül énekel, dúdol	vin.
säomum	információ	n.
kosman	csodálatos, klassz, fantasztikus	adj.
nìksman	csodálatosan	adv.
letsim	eredeti, egyedi, nem más forrásból származó	adj.
lesngä'i	eredeti, kezdetben vagy kezdettől fogva létező, első a sorban	adj.
nìtsim	eredetileg, eredeti módon, eredetien	adv.
nìsngä'i	eredetileg, először	adv.
ngong	fásult, tespedt, lusta	adj.
walak	energikus, aktív	adj.
tìngong	fásultság, lustaság	n.
txi	sietség, igyekezet	n.
letxi	sietős, kétségbeesett	adj.
nìtxi	sietve, kétségbeesetten	adv.
letxiluke	ráérős (sietség nélküli)	adj.
nìtxiluke	ráérősen, nyugodtan	adv.
kulat	felfed, kimutat, leleplez (szó szerint és átvitt értelemben is)	vtr.
txantompa	zivatar, felhőszakadás	n.
meyam	ölel, karol, karjaiban tart	vtr.
sämyam	ölelés, karolás	n.
fìtsap	egymást	adv.
nuä	túl (valamin)	adp.
kanfpìl	összpontosít, koncentrál	vin.
fmokx	féltékenység, irigység	n.
nìfmokx	féltékenyen, irigyen	adv.
kìmar	szezonális (étel, zöldség vagy állat)	adj.
nìkmar	megfelelő időben, alkalmasint	adv.
nìngong	fásultan, lustán	adv.
säpom	csók	n.
kxukx	lenyel	vtr.
txewm	ijesztő, félelmetes	adj.
hìmpxì	kisebbség, kis rész	n.
kawnglan	gonosz, rossuindulatú	adj.
nutx	vastag	adj.
flì	vékony	adj.
flìnutx	vastagság	n.
sneyä	saját(ja) egyes szám első személy	pn.
säsyep	csapda	n.
yora'tu	győztes	n.
snaytu	vesztes	n.
way a plltxe	vers szavalás (melodikus elbeszélés)	ph.
way a rol	vers éneklés	ph.
wayä aylì'u	vers vagy dal szövege	ph.
ultxatu	találkozás résztvevője	n.
wo	nyúl (valamiért)	vtr.
yawo	felszáll, kilő	vin.
tsìk	hirtelen, figyelmeztetés nélkül	adv.
kllwo	leszáll, földet ér	vin.
kllpä	leszáll, földet ér	vin.
sätswayon	repülés (repülés esete)	n.
rawn	kicserél, helyettesít	vtr.
tìrawn	kicserélés, helyettesítés	n.
särawn	csere, helyettes, valami ami helyettesít valami mást	n.
kxeltek	felvesz, emel	vtr.
fngo'	kíván, követel	vtr.
säfngo'	kívánság, követelés	n.
ngam	visszhang	n.
slär	barlang	n.
ngampam	rím	n.
ngampam si	rímel	vin.
faoi	sima	adj.
ekxtxu	durva	adj.
yo'	tökéletes(nek lenni), hibátlan(nak lenni)	svin.
nìyo'	tökéletesen, hibátlanul	adv.
nìyol	röviden, kurtán (időben)	adv.
tìyo'	tökéletesség	n.
'ipu	humoros, vicces, mulattató	adj.
tì'ipu	humor	n.
tìfmi	próba, kíséllet	n.
sä'ipu	valami humoros	n.
hangvur	vicc, mulatságos történet	n.
lì'uvan	szóvicc, szójáték	n.
kanom	megszerez, kap	vtr.
säkanom	szerzemény, tulajdon	n.
srìn	áthelyez, átad egyiktől a másiknak (ritkán használatos prefixum nélkül)	vtr.
käsrìn	kölcsön ad	vtr.
zasrìn	kölcsön vesz	vtr.
säsrìn	kölcsön adott vagy kölcsön vett dolog	n.
pxìmun'i	feloszt, részekre vág	vtr.
lätxayn	csatában legyőz, meghódít	vtr.
sälätxayn	vereség, legyőzöttség	n.
yll	közösségi, közös	adj.
nìyll	közösen, közös módon	adv.
hona	kedves, imádnivaló, cuki	adj.
tìhona	cukiság, kedvesség	n.
fäkä	felmegy, felszáll	vin.
fäza'u	feljön, felszáll	vin.
kllza'u	lejön, leereszkedik	vin.
sämok	javaslat	n.
mal	megbízható, szavahihető	adj.
nìmal	bízva, habozás nélkül	adv.
tìmal	megbízhatóság	n.
kllyem	temet	vtr.
nìtsyìl	mászva	adv.
sätsyìl	mászás, megmászás	n.
rìn	fa (anyag)	n.
flawkx	bőr (anyag)	n.
'ana	inda	n.
tsngawpay	könny	n.
tsngawpayvi	könnycsepp	n.
nìhona	kedvesen, édesen	adv.
lepay	vizes	adj.
'ul	növel	vin.
nän	csökkent	vin.
nìnän	kevésbé	adv.
nì'ul'ul	növekvő mértékben, egyre inkább	adv.
nìnänän	csökkenő mértékben, egyre kevésbé	adv.
mek	üres; vagy átvitt értelemben: ``értéktelen"	adj.
leioae	tisztelet	n.
leioae si	tisztel	vin.
säwìntxu	bemutató, kiállítás	n.
tì'i'a	befejezés	n.
srer	megjelenik, megvalósul, láthatóvá válik	vin.
'ìp	eltűnik, elvész (szem elől)	vin.
tsong	völgy	n.
tsongtsyìp	gödröcske (arcon)	n.
ro'a	hatásosnak lenni, félelmet vagy tiszteletet kelteni	vin.
säro'a	hőstett, teljesítmény, nagy tett	n.
säro'a si	nagy tettet hajt végre	vin.
txanro'a	híresnek lenni	vin.
velek	felad, megad(ja magát)	vin.
spono	sziget	n.
txew	határ, széle vminek, szegély, vég	n.
txewnga'	véges, nem határtalan	adj.
litx	éles (mint egy penge)	adj.
fwem	tompa, életlen	adj.
syura	energia (fizikai vagy szellemi)	n.
syuratan	biolumineszcencia, fénykibocsátás	n.
txonkrr	éjjel	adv.
yuey	szép (belső szépség)	adj.
kxem	függőlegesnek lenni	vin.
txay	vízszintesnek lenni	vin.
nìkxem	függőlegesen	adv.
nìtxay	vízszintesen	adv.
klltxay	a földön feküdni	vin.
klltxeykay	lefektet (vmit) a földre	vtr.
yo	felszín, felület	n.
kxemyo	fal, függőleges felület	n.
fyep	(meg)fog, kézben tart, markol	vtr.
nìk'ärìp	szilárdan	adv.
nìklonu	erősen, rendületlenül, állhatatosan	adv.
nìktungzup	gondosan, erősen	adv.
nìsyep	szorosan, vasmarokkal	adv.
nìmeyp	gyengén, lazán	adv.
säfyep	fogantyú, kilincs	n.
slan	támogat (érzelmileg, szociálisan vagy személyesen)	vtr.
tìslan	támogatás (érzelmi, szociális vagy személyes)	n.
tìeyktan	vezetőség	n.
'llngo	csípő	n.
zare'	homlok, szemöldök	n.
flawm	arc, orca	n.
prrku	(anya)méh	n.
ngep	köldök	n.
tawsyuratan	sarkifény	n.
syeha	lélegzet	n.
syeha si	lélegzik	vin.
sko	mint..., ... szerepében	adp.
sna'o	készlet, csoport, halom, rakás	n.
snatxärem	csontváz	n.
snafpìlfya	filozófia	n.
snatanhì	csillagkép	n.
sästarsìm	gyűjtemény (személy által szándékosan összerakott)	n.
tsu'o	képesség	n.
krra	amikor, abban az időben mikor	conj.
snatanhìtsyìp	csillagcsoport	n.
pìwopxtsyìp	ködfolt	n.
tìterkup	halál (elvont értelemben)	n.
maweypeyyu	türelmes személy	n.
ftxulì'u	szónokol, beszédet mond	vin.
ftxulì'uyu	szónok, (nyilvános) beszélő	n.
säftxulì'u	beszéd, szónoklat	n.
tìftxulì'u	nyilvános beszéd	n.
slantire	inspiráció, ihlet	n.
slantire si	inspirál	vin.
kum	eredmény	n.
kuma	hogy (ennek eredményeként)	conj.
akum	hogy (ennek eredményeként)	conj.
fyel	lepecsétel, hozzáférhetetlenné tesz	vtr.
zey	különleges, különböző	adj.
vll	jelez, mutat	vin., vtr.
eykyu	vezető (ideiglenesen, kisebb csoporté pl. vadászoké)	n.
am'ake	biztos, magabiztos	adj.
nam'ake	magabiztosan	adv.
kezemplltxe	természetesen, mondani sem kell	adv.
tare	összeköt, összekapcsol, kapcsolatban van	vtr.
nìsoaia	(együtt) mint egy család	adv.
nìolo'	(együtt) mint egy klán	adv.
sätare	kapcsolódás, kapcsolat	n.
sloa	széles	adj.
snep	keskeny	adj.
slosnep	aaa	n.
peslosnep	milyen széles	inter.
slosneppe	milyen széles?	inter.
hoet	hatalmas, terjedelmes, kiterjedt	adj.
nìhoet	széles körben, kiterjedten	adv.
so'ha	lelkesnek lenni valami iránt, lelkesedést mutatni valamiért, izgatottnak lenni valami miatt, lelkesedni	vtr.
tìso'ha	lelkesedés, pozitív hozzáállás	n.
nìso'ha	lelkesen	adv.
leso'ha	lelkes, buzgó	adj.
tsawlultxa	nagygyűlés, konferencia	n.
zìsìtay	jövő év	n.
tìtsunslu	lehetőség	n.
numultxa	tanóra	n.
numultxatu	osztálytárs, egy osztály tagja	n.
snanumultxa	tanfolyam, kurzus (tanórák sorozata)	n.
tìflä	siker (általánosságban)	n.
säflä	siker (konkrét dologban)	n.
mesrram	tegnapelőtt, két napja	n., adv.
mesrray	holnapután, két nap múlva	n., adv.
pxesrram	3 napja	n., adv.
pxesrray	3 nap múlva	n., adv.
mong	függ valamitől, számit, bízik	vtr.
sru'	zúz, tapos	vtr.
'ekxin	szoros	adj.
um	laza	adj.
'ekxinum	szorosság, lazaság	n.
pekxinum	milyen szoros, milyen laza?	inter.
zeswa	fű	n.
zeswavi	fűszál	n.
lezeswa	füves	adj.
lopx	pánikba esik	vin.
hifwo	menekül, szökik	vin.
yrrap	vihar	n.
'rrpxom	mennydörgés	n.
rawm	villámlás (általános kifejezés)	n.
rawmpxom	villámlásmennydörgés	n.
se'ayl	egyedülállóan magas, vékony vízesés, amely magas szikláról vagy lebegő hegyről folyik le (megszámlálható)	n.
kxor	erős vízesés, jellemzői: fültépő hangja és halálos ereje (megszámlálható, de csak ritkán)	n.
syanan	egy csepp vagy kisebb vízesések sorozata, amelyek egy folyamból vagy tavakból folynak (megszámlálható)	n.
rurur	sziklák között, lejtősen folyó patak (megszámlálható)	n.
tseltsul	vadvízi zuhatag (megszámlálható, de csak ritkán)	n.
tìmeyp	gyengeség	n.
am'aluke	kétség nélkül	adv.
atanzaw	elágazó villám	n.
nìsìlpey	remélhetőleg	adv.
talun	... miatt	adp.
nìTsyungwen	Zhongwen	adv.
reykol	zenél, énekeltet (költői)	vtr.
nrra	büszkeség	n.
lenrra	büszke	adj.
nìnrra	büszkén	adv.
snonrra	önteltség, önelégültség	n.
lesnonrra	öntelt	adj.
nrr	ragyog, fénylik	vin.
ylltxep	közös tűz vagy tűzhely	n.
txeptseng	tűzhely, tűz helye	n.
ralnga'	értelmes, tanulságos, oktató jellegű	adj.
munsna	pár	n.
fyin	egyszerű	adj.
ep'ang	összetett	adj.
epxang	kőedény, mérges rovar tárolására	n.
fyinep'ang	összetettség foka	n.
pefyinep'ang	mennyire összetett?	inter.
fyinep'angpe	mennyire összetett?	inter.
sngä'itseng	kezdet, kezdő helyzet	n.
srungsiyu	segéd, segítő	n.
srungtsyìp	hasznos tipp	n.
spulmokri	telefon	n.
syeprel	fényképezőgép, kamera	n.
swoa	részegítő ital, vagy ``szesz''	n.
rou	részegnek lenni, vagy berúgni	vin.
pamrelvi	betű (fonetikus jel)	n.
snapamrelvi	abc	n.
tìtxen si	felébred, felébreszt	vin.
fnetxum	allergén	n.
zet	tart, kezel (érzelmileg), viselkedik valakivel szemben	vtr.
ha'	illik, megfelel, kiegészít, illeszkedik, természeténél fogva erősít	vin.
syon	vonás, jellegzetesség, tulajdonság, ismertetőjel, jellemvonás, külső megjelenés, oldal, tulajdonság	n.
ran	belső tulajdonság, lényeg, valaminek az alapvető természete, személyiség	n.
fyole	fenséges, magasztos, a tökéletesnél is jobb	adj.
loran	elegancia, kecsesség, báj	n.
fe'ran	rossz természet, valami rosszul kitervelt vagy eredendően  hibás	n.
reyfya	életmód, kultúra	n.
fe'ranvi	hiba, deformáltság, folt, rossz tulajdonság	n.
nìran	alapvetően, alapjában, lényegében	adv.
mo	terület, völgy, bekerített nyílt terület	n.
snomo	magán terület, ahova vissza lehet vonulni	n.
wum	körülbelül, durván	adv.
kesran	olyan amilyen, középszerű	adj.
nìksran	középszerűen	adv.
yewla	csalódás, meghiúsult elvárások miatti érzelmi csalódottság, kiábrándulás	n.
leyewla	kiábrándító	adj.
nìyewla	kiábrándítóan, csalódást okozva	adv.
yawnyewla	összetört szív, sebzett szív	n.
ve'o	rend (rendetlenség vagy káosz ellentéte), rendezettség	n.
vezo	rendben van, rendezett	vin.
vezeyko	rendbe rak, redszerez	vtr.
vefya	rendszer, eljárás, folyamat, módszer	n.
velke	kaotikus, rendetlen, rendezetlen, összevissza	adj.
venga'	rendezett	adj.
nìfnu	halkan	adv.
sätaron	vadászat (egy konkrét esemény)	n.
wäsul	versenyez	vin.
tìwäsul	verseny	n.
säwäsul	verseny	n.
säwäsultsyìp	mérkőzés	n.
tìmwiä	becsületesség, igazság(osság)	n.
snew	szorít, feszesít	vtr.
txantxew	maximum	n.
snewsye	hátborzongató, kísérteties	adj.
hìmtxew	minimum	n.
txantxewvay	maximálisan, legfeljebb	adv.
hìmtxewvay	minimálisan, legalább	adv.
hefi	érez (szagot!)	vtr.
ewku	i.(t)	vtr.
zìm	érez (érintéssel!)	vtr.
yune	hallgat (figyel valamilyen hangra)	vtr.
syam	szagol	vtr.
'ur	látvány, kinézet, megjelenés	n.
sur	íz, zamat	n.
zir	érintés, érzés, textúra	n.
tse'atswo	látás, látvány	n.
stawmtswo	hallás	n.
hefitswo	szaglás	n.
ewktswo	ízlelés	n.
zìmtswo	érintés	n.
fkan	olyan érzés/szagú/ízű/ mint... , úgy néz ki/hangzik mint...	vin.
onlor	jószagú	adj.
onvä'	rossz szagú	adj.
we'ay	savanyú, keserű	adj.
wip	sós	adj.
fwang	ízletes, pompás, bőséges	adj.
nget	rothadó fa és levelek szagára emlékeztető, nyirkos szagú (nem állati)	adj.
kxänäng	bomló állat vagy rothadó hús szagára emlékeztető	adj.
sosul	közelben folyó víz, eső vagy nedves növényzet kellemes illatára emlékeztető	adj.
unyor	édes illatú/aromájú (pl. virág ; utalhat a na’vik által használt fűszerre is)	adj.
atxar	élő állat szagára emlékeztető (pl. ivóhely közelében)	adj.
inanfya	érzék (érzékelés)	n.
uvan letokx	fizikai vagy atlétikai  játék, sport	n.
ftärpa	bal oldal	n.
skiempa	jobb oldal	n.
rengop	tervez	vtr.
tìrengop	tervezés	n.
särengop	terv, tervezet	n.
ingyen	titkozatosság vagy értetlenség érzése	n.
sngumtsim	aggasztó dolog, aggodalom oka/forrása	n.
yayayrtsim	zavaros dolog, zűrzavar oka/forrása	n.
ingyentsim	rejtély, talány, rejtvény, titokzatosság	n.
ingyentsyìp	trükk, bűvészmutatvány, ügyes/speciális módszer	n.
ningyen	titokzatosan, rejtélyes módon	adv.
ingyenga'	titokzatos, rejtélyes	adj.
sngunga'	aggasztó, nyugtalanító	adj.
yayayrnga'	zavaros, zavarbaejtő	adj.
yrr	vad, természetes (hamisítatlan, eredeti, változatlan állapotú)	adj.
nìyrr	természetesen, hamisítatlanul	adv.
zäfi	módosított, megváltoztatott, nem eredeti állapotú	adj.
syor	relaxál, kikapcsol	vin.
tìsyor	relaxáció	n.
tìfnunga'	csendes	adj.
späpeng	rendbe hoz za magát(képletesen)	vin.
'anla	sóvárog (valami után)	vtr.
sä'anla	sóvárgás	n.
lie	élmény, tapasztalat	n.
tsìlpey	remény (elvont)	n.
säsìlpey	hope (konkrét)	n.
kelsar	haszontalan, hiábavaló	adj.
yì	szint, fok, perem, széle valaminek	n.
snayì	lépcsősor	n.
kxaylyì	magas szint	n.
kxamyì	középszint	n.
tìmyì	alacsony szint	n.
flrr	gyengéd, kedves, lágy (személy vagy dolog)	adj.
nìflrr	gyengéden, lágyan	adv.
tìflrr	gyengédség	n.
ngä'än	szenved (érzelmileg)	vin.
kelkin	felesleges	adj.
nìkelkin	feleslegesen	adv.
sängä'än	szenvedés (érzelmi), depresszió	n.
'eylanay	ismerős (leendő barát)	n.
eyktanay	helyettes, megbízott, leendő vezető	n.
tsulfätunay	leendő mester	n.
karyunay	leendő tanár	n.
tsan'ul	javul, jobb lesz	vin.
fe'ul	rosszabbodik	vin.
tìtsan'ul	javulás (általános, elvont értelemben)	n.
tìfe'ul	rosszabbodás (általános, elvont értelemben)	n.
sätsan'ul	javulás (konkrét esetben)	n.
säfe'ul	rosszabbodás	n.
frafya	mindenhogy	adv.
postì	bejegyzés, post	n.
ketsran	mindegy, bármi	adj.,  conj.
kangay si	érvényesít, megerősít	vin.
txurtel	kötél	n.
ropx	lyuk (átmenő) 	n.
tsongropx	lyuk, üreg (aminek van vége vagy alja)	n.
tsrul	fészek (állaté)	n.
yayotsrul	madárfészek	n.
lini	állat kicsinye (emlősé, madáré, halé, rovaré)	n.
tarnioang	ragadozó	n.
rong	alagút	n.
swek	bot, pálca	n.
mektseng	hézag, rés	n.
tsenga	ahol	conj.
fta	csomó	n.
fta si	csomóz	vin.
fwi	csúszik, siklik	vin.
oìsss si	dühösen mordul	vin.
il	hajlik	vin.
kxakx	törik	vin.
ftumfa	ki(felé), belülről	adp.
sä'eoio	ünnepély	n.
sä'eoio si	ünnepel, ünnepélyen részt vesz	vin.
kur	lóg	vin.
nìtkan	szándékosan, akarattal	adv.
nìtkanluke	véletlenül, akaratlanul	adv.
nui	elbukni, hibázni, sikertelennek lenni	vin.
nìnu	sikertelenül, hiába	adv.
tìnui	sikertelenség (elvont fogalom)	n.
sänui	bukás, sikertelenség (konkrét esetben)	n.
fngä'	könnyít magán; WCzik	vin.
zun	ha	conj.
zel	akkor	adv.
'ekxinumpe	milyen szoros, milyen laza	inter.
okup	tej	n.
loi	tojás	n.
tsyeym	kincs; ritka és értékes dolog	n.
wokau	ingadob	n.
srä	szövet	n.
srok	gyöngy (dísz)	n.
pxayopin	színes, tarka	adj.
tsyoklìt	csokoládé	n.
paynäpll	ananász	n.
pamrelsiyu	író	n.
rel arusikx	film, videó	n.
lì'upuk	szótár	n.
lì'upuk	szótár	n.
nìkemweypey	türelmetlenül	adv.
kelemweypey	türelmetlen	adj.
'on	alak, forma	n.
salewfya	irány, menetirány	n.
koum	kerekített, hajlított, görbe	adj.
ko'on	kör, ovális, nagyjából kerek forma	n.
yo'ko	kör	n.
renulke	rendhagyó, véletlenszerű	adj.
vawt	tömör, nem üreges	adj.
momek	üreges, nem tömör	adj.
yeyfya	egyenes vonal	n.
yak	elágazás	n.
yak si	elágazik, irányt vált	vin.
nìyeyfya	egyenesen előre, egyenes vonalban	adv.
nìftär	balra	adv.
nìskien	jobbra	adv.
'oratsyìp	kis tó, medence	n.
nìyawr	helyesen, jól	adv.
tìsteftxaw	vizsgálat	n.
yoa	cserébe	adp.
txolar	dollár	n.
ewro	Euro	n.
lawnol	nagy öröm	n.
ley	értékes, megéri	vin.
säfmi	próba, kísérlet	n.
nìfkeytongay	valójában	adv.
mowar	tanács	n.
mowar si	tanácsol	vin.
mowarsiyu	tanácsadó	n.
kakpam	süket	adj.
tìkakpam	süketség	n.
pxek	rúg, lök	vtr.
kolan	vagyis, illetve, akarom mondani	intj.
hena	hord, visz	vtr.
sähena	tároló, konténer, tartály	n.
paysena	víztartály	n.
tutsena	hordány	n.
tstalsena	késtok	n.
swizawsena	tegez (az ikran nyergéhez erősített)	n.
tìkakrel	vakság	n.
ngoa	sár	n.
mawfwa	után	conj.
neni	homok	n.
fwep	por (felületen)	n.
fwopx	por (a levegőben)	n.
nìyey	egyenesen	adv.
'al	pazarol	vtr.
tì'al	pazarlás	n.
le'al	pazarló	adj.
nì'al	pazarlóan	adv.
srey	változat	n.
lupra	stílus	n.
fyolup	rendkívüli, kitűnő, fenséges stílusú	adj.
fe'lup	giccses	adj.
snolup	egyéni stílus	n.
'ongop	tervez	vtr.
'ongopyu	tervező	n.
uniltìrantokxolo'	avatárok csoportja vagy klánja	n.
krrka	alatt, folyamán, közben	adp.
tìreyn	vonat	n.
LosÄntsyelesì	Los Angeles	pn.
tson	kötelesség	n.
nìtson	kötelességtudóan, engedelmesen	adv.
kxìm	parancsol, utasít	vtr.
tsonta	to (kxìmmel)	conj.
tìkxìm	parancsolás, utasítás	n.
tìkxìm si	felette áll (rangsorban), a főnökének lenni	vin.
kxìmyu	parancsnok, főnök	n.
saylahe	stb.	adv.
fpomron	egészség vagy jólét (szellemi)	n.
lefpomron	egészséges (szellemileg)	adj.
kelfpomron	egészségtelen, beteg (szellemileg)	adj.
fpomtokxnga'	egészséges (fizikailag)	adj.
kefpomtokxnga'	egészségtelen (fizikailag)	adj.
fpomronga'	egészséges (szellemileg)	adj.
kefpomronga'	egészségtelen, beteg (szellemileg)	adj.
srefpìl	feltételez	vtr.
srefwa	előtte	conj.
ken'aw	nem csak	adv.
släkop	hanem	adv.
sngum si	aggódik	vin.
väpam	zaj, kellemetlen hang	n.
hawmpam	zaj, szükségtelen hang	n.
lehawmpam	zajos	adj.
nìhawmpam	zajosan	adv.
miklor	jól hangzó	adj.
mikvä'	rosszul hangzó	adj.
narlor	szép (vizuálisan)	adj.
narvä'	csúnya	adj.
zawr	állathang (ordítás, bőgés, stb.)	n.
tìnew	vágy	n.
nopx	eltesz	vtr.
tiam	számol	vtr.
ketsuktiam	megszámlálhatatlan, végtelen (sok)	adj.
txewluke	végtelen	adj.
'umtsa	gyógyszer, orvosság	n.
lang	(meg)vizsgál, felfedez	vtr.
tìlang	felfedezés	n.
sälang	vizsgálat	n.
kxum	nyúlós, kocsonyás, sűrű	adj.
kxumpay	sűrű folyadék, gél	n.
sängop	alkotás	n.
tsyìl	megmászni	vtr.
kxap	fenyegetés	n.
kxapnga'	fenyegető (dolog)	adj.
nìkxap	fenyegetően	adv.
tìftiatu	kutató	n.
tìftiatu kifkeyä	tudós	n.
heyr	mellkas	n.
tseri	észrevesz, megjegyez, tudatában van	vtr.
kxap si	fenyeget	vin.
tìtseri	tudatosság	n.
tìktseri	tudatlanság	n.
yäkx	figyelmen kívül hagy, semmibe vesz	vtr.
tìyäkx	figyelmen kívül hagyás, semmibe vétel	n.
srunga'	hasznos	adj.
säyäkx	figyelmen kívül hagyás, semmibe vétel	n.
ngip	tér, hely, űr	n.
txepram	vulkán	n.
txekxumpay	láva, magma	n.
wrrza'u	kijön, előbukkan	vin.
tskxevi	kavics (természetes erők által simára csiszolt apró kő)	n.
nìkx	kavics (szétmorzsolt kő)	n.
tìralpeng	fordítás, tolmácsolás	n.
unil si	álmodik	vin.
uniltsa	álmodik valamiről	vtr.
mauti	gyümölcs	n.
utu	az erdő teteje	n.
utumauti	banángyümölcs	n.
slayk	fésű, kefe	vtr.
tìkelu	hiány	n.
tompakel	aszály	n.
syuvekel	éhínség	n.
zawprrte'	élvezetesnek lenni	vin.
nawri	tehetséges	adj.
tìnawri	tehetség	n.
susyang	törékeny	adj.
reym	szárazföld	n.
kop	is, szintén	conj.
tuvom	a legnagyobb, legnagyszerűbb	adj.
yengwal	bánat	n.
nip	beszorul, beragad	vin.
hän	háló	n.
'rrko	gurul	vin.
tsngem	izom	n.
tsawsngem	izmos	adj.
wìngay	bizonyít	vtr.
tìwìngay	bizonyítás, bizonyíték (általában)	n.
säwìngay	bizonyíték (konkrét esetben)	n.
tìng zekwä	érint (szándékosan)	vin.
weptseng	weboldal	n.
wep	web (www)	n.
tseotu	művész (általános értelemben)	n.
tìkeftxo	szomorúság	n.
tìkeftxonga'	szomorú	adj.
pamtseongopyu	zeneszerző	n.
lereyfya	kultúrális	adj.
huru	főzőedény	n.
sey	csésze vagy tál (természetes formából minimálisan átalakítva)	n.
'e'in	gubó, héj, hüvely (növényé)	n.
'e'insey	flaska, "ivótök"	n.
sum	csigaház, kagylóhéj (tengeri)	n.
sumsey	ivóedény (kagylóhéjból)	n.
swoasey	egy személyes ivóedény, "korsó" (kagylóhéjból, részegítő italokhoz)	n.
swoasey ayll	több személye ivóedény, "kancsó" 	n.
tsyey	falat, rágcsa, nasi	n.
tsyeytsyìp	falatka	n.
nik	kényelmes	adj.
niktsyey	ételcsomag (ehető levelekbe csomagolt kis adag étel)	n.
merki	hús füstöléséhez használt tartó	n.
ikut	hús aprításához használt rúd	n.
sämunge	szállító eszköz	n.
syusmung	tálca	n.
paysmung	vízszállító eszköz	n.
prrsmung	babahordozó	n.
nivi	függőágy (általános)	n.
swaynivi	családi függőágy	n.
snonivi	egyszemélyes függőágy 	n.
sänrr	ragyogás, fény, lámpa	n.
tsmi	nektár	n.
tsmisnrr	hólyaglámpa, nektárlámpás	n.
seyn	szék, pad, bármely egyéb ülőalkalmatosság	n.
hoan	kényelem	n.
lehoan	kényelmes	adj.
nìhoan	kényelmesen	adv.
kelhoan	kényelmetlen	adj.
fyan	mesterséges tárgy, ami a földtől távol és tisztán tart valamit	n.
fyanyo	asztal	n.
yomyo	tányér	n.
yomyo lerìk	levéltányér	n.
fyanyì	polc	n.
kurfyan	fogas, függesztett tartó	n.
snokfyan	saját fogas	n.
kurfyavi	kampó (lógatni, felfüggeszteni valamit)	n.
seyto	feldarabol (elpusztult állatot)	vtr.
säseyto	húsdaraboló eszköz	n.
yaney	kenu	n.
spulyaney	kenuevező	n.
lal	régi (mip ellentéte)	adj.
txanlal	ősi, nagyon régi	adj.
tsankum	előny, haszon, nyereség	n.
tsankumnga'	előnyös, hasznos, nyereséges	adj.
fekumnga'	hátrányos	adj.
tìmungwrr	kivétel	n.
tìmungwrr si	kivételezik, kivételt tesz	vin.
nawfwe	folyékony (beszédre!)	adj.
fekum	hátrány	n.
plltxeyu	beszélő	n.
pxawngip	környezet	n.
palulukantsyìp	macska (földi állat)	n.
zum	tárgy, dolog (kézzelfogható)	n.
hìpey	tétovázik, habozik	vin.
tìhìpey	tétovázás	n.
snäm	meg(romlik), rohad	vin.
kllrikx	földrengés	n.
sälatem	változtatás	n.
tìlatem	változás	n.
txatx	buborék	n.
lehìpey	tétova	adj.
nìhìpey	tétován	adv.
ronguway	üvölt, vonyít	vin.
ronguwayyu	üvöltő (személy)	n.
ler	sima, egyenletes (mozgásra!)	adj.
nìler	simán	adv.
lo'a	totem, amulet	n.
'ewrang	szövőszék	n.
sa'ewrang	"anyaszövőszék", hatalmas szövőszék	n.
tiretu	sámán	n.
pasuk	bogyó	n.
vozampasukut	"ezerbogyófa", málnához hasonló gyümölcs fája	n.
paskalin	édes bogyó (gyengéd, kedveskedő kifejezés)	n.
fngä'tseng	mosdó, WC (a Földön)	n.
mo a fngä'	mosdó, WC (a Földön)	n.
sa	valamely kihívásra felkészül, nekivág	vin.
tanleng	(fa)kéreg	n.
syokup	súly (fizikai)	n.
kewan	kor	n.
tìnvi	feladat, tennivaló	n.
tìnvi si	feladatot végrehajt, valamit megcsinál	vin.
txanwetseng	fontos és szeretett hely, kb. haza	n.
penghrr	figyelmeztet	vin.
säpenghrr	figyelmeztetés	n.
tì'ul	növekedés	n.
eyawrfya	a megfelelő mód, valaminek a mikéntje	n.
stiwi	csíny, rosszalkodás	n.
stiwi si	rosszalkodik	vin.
stiwinga'	csintalan	adj.
stiwisiyu	csínytevő	n.
rawng	bejárat	n.
syewe	zsír (húsban)	n.
syewenga'	zsíros	adj.
laro si	tisztít	vin.
slukx	szarv	n.
tsin	köröm, karom	n.
ue'	hányni	vtr., vin.
nantangtsyìp	kutya (földi állat), sz.sz.: kis viperafarkas	n.
hiup	köp	vin., vtr.
räptum	durva, közönséges, udvariatlan	adj.
txanlokxe	törzsi birtok / tartomány, kb.: ország	n.
tsamsä'o	háborús fegyver	n.
tìtxurnga'	erős	adj.
leym	kiált	vim.
nìzen	szükséges	adv.
kenzen	nem szükséges	adv.
pllhrr	figyelmeztet	vin.
säpllhrr	figyelmeztetés	n.
tspìng	austrapede (struccszerű pandorai állat)	n.
mawup	turtapede (teknősszerű pandorai állat)	n.
pawk	duda, kürt	n.
tekre	koponya	n.
ionar	sikolllovagló napellenző / rostély (a szem fölött viselik)	n.
