"Frontside"	"Flipside"	"Category"
'ampi	beröra	vtr.
'angtsìk	hammerhead, hammarhuvud	n.
'aw	en, ett	num.
'awkx	klippa	n.
'awpo	en individ	pn.
'awsiteng	tillsammans	adv.
'awve	först (ordningstal)	adj.
'e'al	värst	adj.
'eko	attackera, anfalla	vtr.
'ekong	rytm, slag (rytmiskt)	n.
'engeng	jämn	adj.
'eveng	barn	n.
'evi	unge (affectionate form of)	n.
'ewan	ung	adj.
'eylan	vän	n.
'ì'awn	stanna, bli kvar	vin.
'ìheyu	sprial	n.
'Ìnglìsì	Engelska språket	n.
'it	bit, en liten mängd	n.
'itan	son	n.
'ite	dotter	n.
'ok	åtanke, minne	n.
'ong	slå ut, blomstra	v.
'u	sak, objekt	n.
'upe	vad (för sak)	inter.
'upxare	meddelande	n.
a	som, vilken	part.
alaksi	redo	adj.
lìm	långt, vara långt	svin.
apxa	stor	adj.
atan	ljus	n.
atokirina'	frön av det heliga trädet	n.
atxkxe	land	n.
au	trumma (gjord av skinn)	n.
aungia	tecken, omen	n.
awaiei	vålnad av paradiset	n.
awnga	vi	pn.
ayfo	de	pn.
aynga	ni alla, ni	pn.
ayoe	vi, oss (inte du)	pn.
ayoeng	vi, oss (du med)	pn.
äie	syn, vision (andlig, spirituell)	n.
äo	under	adp.
ätxäle	begäran, förfrågan	n.
ätxäle si	begära (med tsnì som klausul för objektet)	vin.
ean	blå, grön	adj.
eltu	hjärna	n.
eltu si	sluta fåna sig, höra upp, skärpa sig	vin.
eltungawng	hjärnmask	n.
emza'u	klara (ett test), överkomma	vtr.
eo	inför, framför (en plats)	adp.
eyawr	rätt, korrekt	adj.
eyaye	warbonnet	n.
eyk	leda	vtr.
eyktan	ledare	n.
fa	med, med hjälp av	adp.
fahew	lukt	n.
fìfya	såhär, det här sättet	adv.
fìkem	den här (handlingen)	pn.
fìpo	den här personen (eller saken)	pn.
fìtxan	så, i sådan utsträckning	adv.
fìtseng	här, det här stället	adv., n.
fìtsenge	här, det här stället	adv., n.
fì'u	den här (saken)	pn.
fkarut	skala	v.
fkew	mäktig	adj.
fko	man, dem (används för singular) (ospecificerade agent)	pn.
flä	lyckas	vin.
fmawn	nyheter, något att rapportera	n.
fmetok	testa	vtr.
fmi	försöka	vtrm.
fngap	metall	n.
fngapsutxwll	metallföljande planta	n.
fnu	tyst, vara tyst	vin.
fo	de	pn.
fpak	avvakta, avbryta åtgärder	v.
fpe'	skicka	vtr.
fpeio	utmaning (högtidlig)	n.
fpi	för sakens skull, till förmån för	adp.
fpìl	tänka	vtr.
fpom	välmående, fred, lycka	n.
fpxafaw	manet	n.
fpxäkìm	stiga in,	vin.
fra'u	allt, alla saker	pn.
frakrr	alltid, hela tiden	adv.
frapo	alla	pn.
frrfen	besöka	vtr.
frrtu	gäst, besökare	n.
ftang	sluta	vim.
fte	så att, för att kunna	conj.
fteke	så att inte, för att inte	conj.
ftia	studera	vtr.
ftxì	tunga	n.
ftxozä	högtid, lyckligt tillfälle	n.
ftu	från (riktning)	adp.
ftue	enkel, simpel	adj.
ftxavang	passionerad	adj.
ftxey	välja	vtr.
fu	eller	conj.
futa	det	pn., sbd.
fwa	att,  (klausul bisatsmarkör)	pn., sbd.
fya'o	väg, stig, sätt	n.
fyape	hur	inter.
fyawìntxu	guide (med dativ av den guidade saken)	vin.
ha	så, i så fall	adv.
hahaw	sova	vin.
hapxì	del, bit	n.
hasey	färdig, klar	adj.
hawnu	skydda, beskydda	vtr.
hì'i	liten (i storlek)	adj.
hiyìk	konstig	adj.
hol	några, få	adj.
holpxay	nummer	n.
hrrap	fara	n.
hu	med (ackompanjemang)	adp.
hufwe	vind	n.
hum	lämna	vin.
i'en	stränginstrument	n.
ikran	vålnad	n.
ikranay	skogsvålnad	n.
ioang	djur, best	n.
irayo	tack	n., intj.
ìlä	av, via, efter	adp.
ka	över, grundligt täckande	adp.
kä	åka, gå, fara	vin.
kali'weya	en art av giftigt spindeldjur	n.
kalin	söt (smak)	adj.
kaltxì	Hej	intj.
kämakto	rid ut	v.
kame	se, se in i, förstå, känna (spirituellt)	vtr.
kan	sikta	vtrm., vtr.
kangay	giltig	adj.
kar	lära ut	vtr.
karyu	lärare	n.
kato	rytm	n.
kawkrr	aldrig	adv.
kawng	dålig, ond	adj.
kawtu	ingen	pn.
ke	inte	adv.
ke'u	ingenting, ingenting alls, inget alls	pn.
kehe	nej	part., intj.
kelku	hus, hem	n.
kelku si	bo, leva	vin.
kem	sak, handling, dåd	n.
kempe	vilken (handling)	inter.
kenong	representera, företräder, exemplifierar	vin.
kerusey	död	adj.
ketuwong	alien, utomjording	n.
kewong	främmande, utomjordisk	adj.
keye'ung	vansinne	n.
kifkey	värld (fysisk, solid)	n.
kilvan	flod	n.
kìm	snurra	vtr.
kin	behöva	vtr.
kinam	ben	n.
kinamtil	knä	n.
kìng	tråd	n.
kip	bland	adp.
kìte'e	tjänst	n.
kllfro'	vara ansvarig	svin.
kllkulat	gräva upp	vtr.
kllkxem	stå	vin.
kllpxìltu	område	n.
kllte	mark	n.
ko	hålla med	part.
kop	också	adv.
koren	regel, riktlinje	n.
krr	tid	n.
krrnekx	ta tid, konsumera tid	vin.
krrpe	när	inter.
kunsìp	flygvapen	n.
kurakx	driva ut	vtr.
kxam	mitt, mittpunkt	n.
kxamtseng	center, mitt, plats i mitten	n.
kxangangang	boom, pang, crash (onomatopoetikon)	intj.
kxanì	förbjuden	adj.
kxawm	kanske	adv.
kxener	rök	n.
kxetse	svans	n.
kxeyey	fel, misstag	n.
kxll	attack	n.
lahe	annan	adj.
lam	verka som, se ut	vin.
lapo	en annan (person eller sak)	pn.
latem	ändra	vin.
law	klar, säker	adj.
lefpom	lycklig, fridfull, glad (inte för folk), trevlig	adj.
lertu	kollega	n.
letrr	daglig	adj.
letsunslu	möjlig	adj.
lì'u	ord	n.
lì'fya	språk	n.
lok	närma sig	vtr.
lonu	släppa, släppa fri, låta gå	vtr.
lor	vacker, behaglig för sinnen	adj.
loreyu	helicoradian, vacker spiral	n.
lrrtok	leende	n.
lrrtok si	le	vin.
lu	vara	vin., svin.
lun	andledning	n.
lumpe	varför	inter.
ma	O (vokativ markör)	part.
makto	rida	vtr.
mawey	lugn	adj.
mefo	de, de två	pn.
menari	ögon (två)	n.
meoauniaea	harmoni, leva ett med naturen	n.
meuia	ära, heder	n.
meyp	svag	adj.
mi	ännu, fortfarande, som tidigare	adv.
mip	ny	adj.
mikyun	öra	n.
mì	i, på	adp.
mìn	vända	vin.
mìso	borta (position)	adv.
mllte	hålla med, samtycka	vin.
moe	vi två (du är inte inräknad)	pn.
mokri	röst	n.
muiä	rättvis, rätt, korrekt	adj.
mun'i	skära	v.
mune	två	num.
munge	ta, ta med	vtr.
mungwrr	förutom	adp.
muntxa	parad, gift	adj.
na	som, likt	adp.
na'rìng	skog	n.
Na'vi	Folket, rasen som lever på Pandora	prop.n.
nang	överraskning, utrop, uppmuntran (admirativ)	part.
nantang	Viperwolf	n.
nari	öga	n.
nari si	se upp, var försiktig	vin.
nawm	mäktig, nobel	adj.
ne	till, mot (riktning)	adp.
ne'ìm	tillbaka (riktning)	adv.
nekx	bränna upp, konsumera	vtr.
neto	bort (riktning)	adv.
new	vilja ha, vilja	vtrm.
niä	greppa tag, ta tag	vtr.
nì'aw	bara, endast	adv.
nìawnomum	som ni vet, som sagt (vardagligt tal [naw.no.mum])	adv.
nì'awtu	ensam (som en person)	adv.
nì'awve	först	adv.
nì'it	lite, lite grann (abstrakt)	adv.
nì'ul	mer, mera	adv.
nìayoeng	som oss, som vi gör (vardagligt [naj.wEN])	adv.
nìftue	enkelt	adv.
nìftxavang	passionerat, med hela hjärtat	adv.
nìhawng	alltför, (för)	adv.
nìltsan	väl, bra	adv.
nìmun	igen	adv.
nìn	titta på	vtr.
nìngay	sannerligen	adv.
nìtam	nog, tillräckligt (efter ett adjektiv)	adv.
nìteng	också	adv.
nìtut	kontinuerligt, oavbrutet	adv.
nìtxan	mycket (abstrakt), väldigt	adv.
nìwin	snabbt	adv.
nìwotx	alla, i helhet, helt	adv.
nulkrr	längre (tid)	adv.
nulnew	föredra (ii)	vtrm.
nume	lära	vin.
nga	du	pn.
ngawng	mask	n.
ngay	sann	adj.
ngenga	du (ärofull, högtidlig form)	pn.
ngim	lång (fysisk längd)	adj.
ngop	skapa	vtr.
ngrr	rot	n.
nguway	ylande, viperwolfylande	n.
oe	Jag, mig	pn.
oeng	vi två, du och jag	pn.
oeyk	orsak	n.
ohe	Jag (högtidligt eller med vördnad)	pn.
olo'	klan	n.
olo'eyktan	klan ledare	n.
omum	veta, känna till	vtr.
ontu	näsa	n.
pähem	anlända	vin.
pak	pytsan! (nedvärdering)	part.
pa'li	direhorse, häst	n.
palulukan	thanator (stort kattliknande rovdjur på Pandora)	n.
pam	ljud	n.
pamtseo	musik	n.
pamtseowll	cat ear, musikplanta	n.
pängkxo	prata, konversera, ha en konversation	vin.
pänutìng	lova (en sak till någon)	vtr.
pätsì	bricka, emblem	n.
pawm	fråga	v.
pay	vatten, vätska	n.
paywll	vattenväxt, dapophet	n.
pe	interr. frågemarkör	affix
pe'un	bestämma sig, besluta, avgöra	vtr.
pefya	hur	inter.
pehem	vad för, vilken (handling)	inter.
pehrr	när	inter.
pelun	varför	inter.
peng	berätta	vtr.
penghrrap	binärt solsken, fransad lampa	n.
peseng	vart, var	inter.
pesu	vem	inter.
peu	vad (för sak)	inter.
pey	vänta, vänta på	vin.
pizayu	förfader	n.
plltxe	prata, tala	v.
po	han/hon	pn.
poan	han (inte pluralform: använd (ay)fo)	pn.
poe	hon (det finns ingen pluralform: använd (ay)fo)	pn.
pongu	grupp av människor, parti	n.
prrnen	nyfödd, bebis	n.
prrnesyul	knopp	n.
prrte'	njutbar, trevlig (om en aktivitet)	adj.
pxan	värdig	adj.
pxasìk	aldrig!, skit i det! (vulgärt)	intj.
pxasul	färsk, tilltalande som mat	adj.
pxay	många	adj.
pxey	tre	num.
pxi	vass, skarp	adj.
pxìm	ofta	adv.
pxiut	vasst träd	n.
pxorna'	exploderande frö	n.
pxun	arm	n.
pxuntil	armbåge	n.
rä'ä	gör inte (för negativa krav, endast kommandon)	part.
ral	mening, betydelse	n.
ralpeng	tolka (ii)	vtr.
rawke	varningsskall, rop för att varna, "stridsberedskap!"	intj.
rel	bild	n.
reltseo	visuell konst	n.
reltseotu	konstnär	n.
renu	mönster	n.
rey	leva	vin.
rikx	flytta, byta position	vin.
rim	gul	adj.
rina'	frö	n.
riti	stingbat (fladdermusdjur som lever på Pandora)	n.
rol	sjunga	v.
ronsem	sinne	n.
rum	boll	n.
rumut	bollträd	n.
run	hitta, upptäcka	vtr.
rutxe	snälla	intj.
sa'nok	mamma	n.
sa'nu	mamsen, mamma (affectionate form of)	n.
san	säga, citera	adv.
sänume	lärande, undervisning	n.
säspxin	sjukdom, smitta	n.
sempu	pappsen, pappa (affectionate form of)	n.
sempul	pappa	n.
set	nu	adv.
sevin	vacker (främst om kvinnor, endast om folk)	adj.
seyri	läpp	n.
seze	blå blomma	n.
si	hjälpverb, ickebindande verb göra	
sì	och (connects two things, can be attached as --sÃ¬: for clauses use)	conj.
sìk	sluta citera	adv.
sìlpey	hoppas (med tsnì för en önskad sak, om inte i självständig klausul) (ii)	vin.
sìlronsem	smart, intelligent (sak)	adj.
sìltsan	bra, duktig, bra gjort	adj.
ska'a	förstöra	vtr.
skxawng	idiot, fårskalle	n.
slä	men	conj.
slu	bli (substantivs predikat med ne i tvetydiga konstruktioner)	vin.
sngä'i	börja, starta	vim.
sngä'ikrr	början, starttid	n.
sngel	skräp	n.
sngeltseng	skräpställe, sopptipp	n.
snumìna	dum, korkad (om en person)	adj.
som	varm, het	adj.
somtìlor	isglass, het skönhet	n.
spaw	tro	vtr.
spxam	svamp	n.
spe'e	fånga	vtr.
spe'etu	fånge	n.
spxin	sjuk	adj.
srak	interj. markör för ja och nejfrågor	part.
srake	interj. markör för ja och nejfrågor	part.
srane	ja	part., intj.
srew	dansa	vin.
srung	hjälp, assistans	n.
stawm	höra	vtr.
steftxaw	undersöka, inspektera	vtr.
stum	nästan	adv.
sutx	följa, spåra	vtr.
swaw	ögonblick	n.
swey	bäst	adj.
swirä	varelse	n.
swizaw	pil	n.
swok	helig	adj.
swotu	helig plats	n.
syaw	kalla (någon)	vin.
syulang	blomma	n.
ta	ifrån (olika användningsområden)	adp.
ta'em	ifrån ovan	adv.
tafral	därför, på grund av det	adv.
täftxu	väva	vtr.
täftxuyu	vävare	n.
takuk	slå till, attackera	vtr.
talioang	sturmbeest (varelse som lever på Pandora)	n.
talun	därför, ifrån anledningen	conj.
taluna	därför, ifrån anledningen	conj.
tam	tillräckligt, okej, OK, det blir bra	vin., intj.
tam tam	lugn, så ja	intj.
tangek	stam (av ett träd)	n.
tanhì	stjärna, självlysande prick	n.
taron	jaga	vtr.
taronyu	jägare	n.
tautral	himmelsträd	n.
taw	himmel, sky	n.
taweyk	därför, baserad på orsaken	conj.
taweyka	därför, baserad på orsaken	conj.
tawsìp	himmelsskepp	n.
tawng	ducka, dyka	vin.
tawtsngal	himmelskopp	n.
Tawtute	Himmelsperson, människa	prop.n.
te	partikel som används i hela namn	part.
tel	ta emot, få, mottaga	vtr.
telem	träns	n.
teng	samma, lika	adj.
tengfya	som, samma sätt som (situationsanpassad likhet)	conj.
tengkrr	under tiden, samtidigt som	conj.
teri	angående, om	adp.
terkup	dö	vin.
teswotìng	tillåta, bevilja	vtr.
teya	full	adj.
teylu	skalbaggslarv	n.
tewti	wow!, uttryck av överraskning och nöje	intj.
til	fog, skrav	n.
tirea	ande	n.
tireafya'o	andeväg	n.
tireaioang	andedjur	n.
tireapängkxo	samtala i förtroende	v.
tì'eyng	svar, respons	n.
tìfmetok	test	n.
tìftang	stoppet, den glottala klusilen	n.
tìfyawìntxu	vägledning	n.
tìhawnu	skydd	n.
tìkangkem	arbete	n.
tìkawng	ondska	n.
tìkenong	exempel	n.
tìkin	behov	n.
tìlor	skönhet	n.
tìng	ge	vtr.
tìng mikyun	lyssna	vin.
tìng nari	titta	vin.
tìngay	sanning	n.
tìpawm	fråga	n.
tìran	gå	vin.
tìyawn	kärlek	n.
tìrey	liv	n.
tìrol	sång (vokal)	n.
tìspxin	sjukdom, tillståndet att vara sjuk	n.
tìtxur	styrka	n.
to	comparative marker than (behaves like an adp.)	part.
tok	vara, ockupera en plats	vtr.
toktor	doktor	n.
tokx	kropp	n.
tompa	regn	n.
toruk	sista skuggan, great leonopteryx	n.
toruk makto	ryttare av sista skuggan	n.
torukspxam	svamp	n.
trr	dag	n.
trram	igår	adv.
tukru	spjut	n.
tul	springa	vin.
tung	tillåta	vtr.
tupe	vem	inter.
tut	kontinuerlig markör	part.
tute	person	n.
tuté	kvinna (person)	n.
tutan	manlig person	n.
tsa'u	den där, det där (saken)	dem.
tsaheylu	band, förbindelse (nervanslutning)	n.
tsakem	den där (handlingen)	dem.
tsakrr	då, den tiden	adv.
tsam	krig	n.
tsampongu	krigsparti, grupp av krigare	n.
tsamsiyu	krigare	n.
tsap'alute	ursäkt	n.
tsatseng	där, det stället	dem., n.
tsatu	den där (personen)	dem.
tsawke	sol	n.
tsawl	stor (i storlek), lång	adj.
tsawlapxangrr	stor, lång rot	n.
tse'a	se (fysiskt)	vtr.
tseng	plats	n.
tsenge	plats	n.
tsengpe	var, vart	inter.
tseo	konst	n.
tskalep	armborst	n.
tsko	båge (vapen)	n.
tsko swizaw	pil och båge	n.
tskxe	sten	n.
tskxekeng	träning, övning	n.
tslam	förstå	vtr.
tsleng	falsk	adj.
tslolam	jag fattar, jag förstår	intj.
tsmuk	syskon	n.
tsmuktu	syskon	n.
tsmukan	broder, bror	n.
tsmuke	syster	n.
tsnì	att (funktionsord)	sbd.
tsngal	kopp, mugg	n.
tspang	döda	vtr.
tsranten	spela roll, vara av värde	vin.
tstew	modig	adj.
tstxo	namn	n.
tsun	kan, kunna	vim.
tswayon	flyga	vin.
tsyal	vinge	n.
tsyo	mjöl	n.
tsyorina'wll	mjölfröväxt	n.
txan	mycket, många (i kvantitet)	adj.
txantsan	utmärkt	adj.
txantslusam	vis	adj.
txe'lan	hjärta	n.
txele	ärende, sak	n.
txen	vaken	adj.
txep	eld	n.
txewk	klubba (vapen)	n.
txey	stoppa, stanna	v.
txìm	rumpa	n.
txìng	lämna, överge	vtr.
txll'u	kalebassväxt, hookagourd	n.
txo	om	conj.
txoa	förlåtelse	n.
txokefyaw	annars, om inte	conj.
txon	natt	n.
txopu	rädsla	n.
txula	bygga, konstruera	vtr.
txum	gift	n.
txumpaywll	giftig vattenväxt	n.
txumtsä'wll	giftsprutande växt	n.
txur	stark (fysiskt)	adj.
ulte	och (klausulkonjunktion)	conj.
ultxa	möte	n.
unil	dröm	n.
uniltìrantokx	avatar, drömvandrarkropp	n.
uniltìranyu	drömvandrare	n.
utral	träd	n.
uvan	spel, lek, uvan letokx sport	n.
uvan si	spela (ett spel)	vin.
vay	upp till	adp.
virä	sprida, föröka	v.
vrrtep	demon	n.
vul	gren (av ett träd)	n.
way	sång (uråldrig, ceremoniell)	n.
waytelem	sångackord	n.
win	snabb	adj.
wìntxu	visa	vtr.
'ewll	planta, växt	n.
wrrpa	utomhus, ute	n., adv.
wutso	middag, serverad måltid	n.
ya	luft	n.
yawne	älskad	adj.
ye'rìn	snart	adv.
yerik	hexapede	n.
yey	rak	adj.
yìm	binda, knyta fast	vtr.
yol	kort (om tid)	adj.
yom	äta	vtr.
yomhì'ang	insektsätare	n.
yomioang	chalice plant, köttätande växt	n.
yomtìng	mata (med dativsobjekt) (ii)	vin.
yur	tvätta	vtr.
za'ärìp	dra, rycka	vtr.
za'u	komma	vin.
zamunge	ta med	vtr.
zawng	skrika	vin.
zekwä	finger	n.
zene	måste	vim.
zìsìt	år	n.
zong	skydda, rädda	vtr.
zongtseng	tryggt ställe, fristad	n.
zoplo	förolämpning	n.
zusawkrr	framtid	n.
Jakesully	idiot, ryttare av toruk	n.
'ärìp	flytta	vtr.
'awstengyem	koppla ihop två saker (ii)	vtr.
'efu	känna, uppfatta, märka	vtr.
'em	laga (mat)	vtr.
'eyng	svara, ge respons	v.
'i'a	sluta, upphöra	vin.
'ia	förlora sig själv (spirituellt sätt)	vin.
fkxake	klia	v.
fmal	upprätthålla, klara av	vtr.
frìp	bita	vtr.
ftem	passera (något)	vtr.
fwew	leta efter, söka	vtr.
hangham	skratta	vin.
vaykrr	tills, ända tills, fram till	conj.
sngap	sticka (med tex. gadd)	vtr.
hawl	förbereda	vtr.
kä'ärìp	trycka	vtr.
kavuk si	förråda	vin.
kllkä	sjunka, dala, gå ner för landning	vin.
latsi	hänga med någon, inte halka efter	v.
lek	lyssna, lyda	vtr.
len	hända	vin.
lew si	täcka, täcka över	vin.
muntxa si	para sig (med någon), gifta sig	vin.
näk	dricka	vtr.
nong	följa, härma	vtr.
oeyktìng	förklara (varför) (ii)	vtr.
pate	komma till en plats, anlända	v.
piak si	öppna	vin.
pom	kyssa	vtr.
pxor	explodera	vin.
salew	avancera, röra framåt	v.
sar	använda	vtr.
sim	nära, vara nära	svin.
sleyku	producera	vtr.
sop	resa	vin.
spä	hoppa	v.
speng	återställa	vtr.
spule	framdriva	vtr.
srese'a	förutspå	vtr.
steyki	göra någon arg	vtr.
sti	arg (intransitivt), vara arg	vin.
sto	vägra (att göra något)	vtrm.
sung	lägga till	vtr.
syep	fånga	vtr.
tatep	tappa bort, förlora ur sikte	vtr.
tätxaw	återvända	vin.
tem	skjuta	vin.
tì'awm si	campa, slå läger	vin.
tì'awm	camping	n.
tìkangkem si	arbeta	vin.
tìng tseng	ge plats, ge med sig	vin.
tìsraw seyki	skada (någon eller något)	vtr.
tìsraw	smärta	n.
tìsraw si	skada, vara smärtsam	vin.
toltem	skjuta	vtr.
tsä'	spruta	v.
tsaheyl si	binda med, åstadkomma nervanslutning	vin.
tsap'alute si	be om ursäkt	vin.
tsawl slu	växa	vin.
tsngawvìk	gråta	vin.
tsre'i	kasta	vtr.
tstu si	stänga	vin.
tsunslu	kan, vara möjligt	vin.
tsurokx	vila	vin.
tungzup	tappa (släppa) (ii)	vtr.
wem	slåss	vin.
win säpi	skynda	vin.
win si	skynda på något, göra något snabbt	vin.
yän	sätta fast, binda	vtr.
yem	sätta dit, placera, sätta	vtr.
zenke	få inte	vim.
zup	falla	vin.
nekll	ner (riktning)	adv.
srung si	hjälpa	vin.
txopu si	vara rädd	vin.
fkip	upp bland	adp.
io	över	adp.
kxamlä	genom (via mitten)	adp.
lok	nära, tätt intill	adp.
maw	efter (tidsmässigt)	adp.
mìkam	mellan	adp.
nemfa	in till, inuti	adp.
pxaw	runt, runt om	adp.
pxel	som, likt	adp.
sìn	på, ovanpå	adp.
takip	ifrån bland, från mellan	adp.
uo	bakom	adp.
luke	utan	adp.
tafkip	från upp bland	adp.
ro	på, vid (plats)	adp.
sre	före (tidsmässigt)	adp.
wä	emot, mot (som i: slåss mot)	adp.
fäpa	topp	n.
alìm	långt bort, på avstånd	adv.
aylaru	till de andra	pn.
kxu	skada	n.
eltu lefngap	dator	n.
kì'ong	långsam	adj.
säfpìl	idé	n.
kefyak	eller hur?, korrekt?	part.
prrwll	mossa	n.
pängkxoyu lekoren	advokat	n.
pamrel	text	n.
pamrel si	skriva	vin.
furia	att (klausul bisatsmarkör)	pn., sbd.
fratseng	överallt	adv.
fratrr	dagligen, varje dag	adv.
frato	superlativsmarkör än alla (beter sig som en adp.)	part.
trray	imorgon	adv.
kea	inte (före ett substantiv)	adj.
ngian	hursomhelst	adv.
skepek	formell	adj.
hufwa	fastän, även	conj.
tup	istället för, snarare än	conj.
'uo	någonting	pn.
tuteo	någon	pn.
tsengo	någonstans	pn.
holpxaype	hur många	inter.
hìm	lite (i kvantitet)	adj.
hìmtxampe	hur mycket	inter.
hìmtxan	mängd	n.
pìmtxan	hur mycket	inter.
lì'upe	vad (för ord)	inter.
pelì'u	vad (för ord)	inter.
ultxarun	träffa, mötas av slump	vtr.
ultxa si	möta någon avsiktligt (använd hu med)	vin.
rangal	önska	vin.
nìrangal	önska (kontrast till fakta)	adv.
txepvi	gnista	n.
nitram	lycklig, glad (om folk)	adj.
fewi	jaga, förfölja	vtr.
stä'nì	fånga	vtr.
sran	ja (vardagligt)	part., intj.
weyn	måla, illustrera	vtr.
fìtrr	idag	adv.
rusey	levande, levande sak	adj., n.
vitra	själ	n.
nìzawnong	säkert	adv.
ftawnemkrr	förr, förr i tiden	n.
txal	rygg, baksida (av kroppen)	n.
tsìng	fyra	num.
mrr	fem	num.
pukap	sex	num.
kinä	sju	num.
vol	åtta	num.
zam	sextiofyra	num.
tìoeyktìng	förklaring	n.
lesar	användbar	adj.
tse	ja, tja, hursomhelst (ord som startar konversation)	part.
skxom	chans, möjlighet	n.
fkxen	grönsak (mat)	n.
syä'ä	bitter	adj.
yemfpay si	doppa i vätska	vin.
yemfpay	doppande, nedsänkning (i vätska)	n.
keng	till och med, så mycket som	adv.
'awlo	en gång	adv.
melo	två gånger	adv.
heyn	sitta	vin.
nìpxim	upprätt, rakt	adv.
pxim	rak upprätt	adj.
tuvon	luta	v.
nìfya'o	på ett sätt som..	adv.
letrrtrr	vanlig, ordinär, (rutinmässig)	adj.
nì'eoio	högtidligt	adv.
'eoio	högtidlig	adj.
rìk	blad, löv	n.
lerìk	lummig, lövrik	adj.
pa'o	sida	n.
kllpa	botten	n.
mìfa	inomhus, inne	n., adv.
nefä	upp (riktning)	adv.
zapxì	framsida (del eller sektion)	n.
käpxì	bak (del eller sektion)	n.
käsatseng	där ute	adv.
ftxey	eller, antingen	conj.
ngaytxoa	förlåt, mina ursäkter (erkännande av skuld och ånger)	intj.
flew	hals	n.
kxa	mun	n.
nikre	hår	n.
pewn	nacke	n.
re'o	huvud	n.
sre'	tand	n.
tsuksìm	haka	n.
key	ansikte	n.
puk	bok	n.
ngäng	mage	n.
ta'leng	skinn, hud	n.
tsyokx	hand	n.
reypay	blod	n.
tsopì	lunga	n.
venu	fot	n.
venzek	tå	n.
ramunong	brunn	n.
payfya	ström (i vatten)	n.
pxawpa	omkrets, gräns	n.
txampay	hav, ocean	n.
'ora	sjö	n.
ekxan	barrikad, hinder	n.
tsim	källa	n.
tsray	by	n.
txayo	fält, öppen terräng, slätt	n.
ukxo	torr	adj.
wew	kall	adj.
fìtxon	ikväll	adv., n.
txonam	igår kväll	adv.
txonay	imorgon kväll	adv.
sekrr	nutid	n.
vur	berättelse	n.
tìpängkxo	konversation, diskussion	n.
tìsrese'a	profetia	n.
nawmtu	stor person (som i mäktig, väldig)	n.
txantstew	hjälte	n.
syuve	mat (kollektivt substantiv, kan inte pluraliseras)	n.
tsngan	kött	n.
tstal	kniv	n.
tete	slö (om egg, knivblad)	adj.
lew	lock, omslag, skydd	n.
'opin	färg	n.
leNa'vi	angående Na'vifolket	adj.
nìNa'vi	som Na'vi, Na'viaktigt	adv.
hapxìtu	medlem	n.
'Rrta	Jorden	prop.n.
fwäkìwll	mantis orchid, orkidéönsyrsa	n.
hì'ang	insekt	n.
payoang	fisk	n.
yayo	fågel	n.
zize'	hellfire wasp, helveteseldgeting	n.
kemlì'u	verb	n.
tstxolì'u	substantiv	n.
ftär	vänster	adj.
skien	höger	adj.
'änsyem	komplett, färdigt	adj.
wotx	helhet, totalhet	n.
mowan	njutbar, behaglig, trevlig (fysiskt, sexuellt)	adj.
vä'	obehaglig för sinnena, vidrig	adj.
tatlam	tydligen, uppenbarligen	adv.
keteng	annorlunda	adj.
numtseng	skola	n.
skxakep	trolig, sannolik, troligt sannolikt	adj., adv.
tìprrte'	njutning	n.
kaw'it	inte alls, över huvud taget (see ke...kaw'it inte...alls)	adv.
nìlkeftang	oavbrutet, utan att sluta	adv.
tì'i'avay	till slutet	adv.
'awm	läger	n.
tìska'a	förstörelse	n.
tìsop	resa	n.
wempongu	trupp, militärklan	n.
asim	i närheten	adv.
klltseng	position	n.
kxutu	fiende	n.
mekre	förnödenheter	n.
tìhawl	förberedelser, plan	n.
tìkan	mål, sikte, mening	n.
tìpähem	ankomst	n.
numeyu	student, elev	n.
soaia	familj (oregelbunded genitivform soaiä)	n.
tìmuntxa	parning, giftermål	n.
yawnetu	en älskad, älskling	n.
yawntu	en älskad, älskling	n.
kakrel	blind	adj.
kanu	smart, intelligent (om en person)	adj.
koak	gammal, åldrad (om levande saker)	adj.
lekye'ung	galen, knäpp	adj.
me'em	harmonisk	adj.
txanew	girig	adj.
txantur	kraftfull	adj.
tì'awpo	individualitet (negativ betydelse), själviskhet	n.
tì'eylan	vänskap	n.
fkay	hatisk	adj.
keltsun	omöjlig	adj.
kxuke	säker	adj.
lehawng	överdriven	adj.
hawng	överflöd	n.
lekin	nödvändig	adj.
stxong	konstigt, okänd	adj.
syen	slutgiltig, sist	adj.
kavuk	förräderi, svek	n.
fpìlfya	tankegång, sätt att tänka	n.
syay	öde	n.
tìfnu	tystnad	n.
tìngop	skapelse	n.
tìpe'un	val	n.
kxitx	död	n.
trr'awve	Söndag	n.
trrmuve	Måndag	n.
trrpxeyve	Tisdag	n.
trrtsìve	Onsdag	n.
trrmrrve	Torsdag	n.
trrpuve	Fredag	n.
trrkive	Lördag	n.
'ango	mjuk (om ett ljud)	adj.
kxayl	hög	adj.
rey'eng	Livets balans	n.
tìme'em	harmoni (allmän känsla)	n.
fnel	typ, sort	n.
fnepe	vilken sort	inter.
pefnel	vilken sort	inter.
zerok	komma ihåg	vtr.
tswa'	glömma	vtr.
tì'efu	känsla	n.
maweypey	vara tålmodig	svin.
tìmweypey	tålmodighet	n.
lemweypey	tålmodig	adj.
nìmweypey	tålmodigt	adv.
tsakrrvay	tills då, under tiden	adv.
ohakx	hungrig	adj.
tìohakx	hunger	n.
tsyosyu	mat gjord av mjöl	n.
vey	mat ifrån djuriskt ursprung, kött	n.
trrpeve	vilken dag (härstammar ifrån trr dag och pe frågemarkör och ve ordningsnummersmarkör)	inter.
pxiswawam	bara ett ögonblick sedan	adv.
pxiset	just nu	adv.
pxiswaway	bara en sekund ifrån nu	adv.
pxiye'rìn	omedelbart (inte så snart som pxiswaway)	adv.
pxisre	precis innan	adp.
pximaw	precis efter	adp.
sok	nylig, senaste	adj.
'awlie	en gång i tiden	adv.
tìkxey	felaktighet	n.
tìkxey si	göra fel, klanta sig	vin.
tìyawr	korrekthet	n.
tìketeng	skillnad	n.
fpomtokx	hälsa (fysisk)	n.
lefpomtokx	frisk, sund	adj.
kelfpomtokx	ohälsosam	adj.
keftxo	ledsen, inte glad, upprörd	adj., intj.
nìkeftxo	oturligt, tråkigt nog	adv.
sraw	smärtsam	adj.
txampxì	majoritet, mest, flest, större del	n.
vurvi	summering, sammanfattning	n.
sänumvi	lektion	n.
letam	tillräcklig	adj.
letsranten	viktig	adj.
nìswey	bäst, optimalt	adv.
nìpxi	i synnerhet	adv.
wok	högljud	adj.
spuwin	gammal (inte för folk), tidigare	adj.
nì'eyng	tillbaka, som svar, i respons	adv.
nìkanu	intelligent, på ett smart sätt	adv.
nìlaw	tydligt, klart	adv.
tìsti	ilska, vrede	n.
tìtxanew	girighet	n.
tìftxey	val	n.
tìkanu	intelligens	n.
tìlam	utseende, uppträdande	n.
tìtslam	förstående, intelligens	n.
tìtxula	byggnad, konstruerad sak	n.
hewne	mjuk (om ett föremål)	adj.
tìm	låg	adj.
laro	ren	adj.
tsewtx	smutsig	adj.
lefngap	metallisk	adj.
txa'	hård	adj.
fwel	trasig	adj.
etrìp	gynnsam	adj.
piak	öppen, klar (för molnfri himmel)	adj.
tstu	stängd, molnigt	adj.
kxll si	attack, anfall	vin.
tsaw	det, den (som intransitiv subjekt)	dem., pn.
tsalsungay	dock, ändå	adv.
oìsss	arg snäsning, "se upp!"	intj.
saa	hotande yl	intj.
sau	uttryck av ansträngning, uff, urgh	intj.
tsahey	uttryck av varning eller frustration, "skit också!"	intj.
wiya	uttryck av varning eller frustration, 'fan!'	intj.
ìley	krigsrop	intj.
vawm	mörk	adj.
tìvawm	mörker	n.
polpxay	hur många	inter.
ke'aw	delad, söndersliten	adj.
nìsti	argt	adv.
teyr	vit	adj.
layon	svart	adj.
pänu	löfte	n.
kew	noll	num.
'eyt	symbolen 8 (inte värdet av åtta)	n.
nayn	symbolen 9 (inte värdet av nio)	n.
trr'ong	soluppgång, gryning	n.
trr'ongmaw	gryning efter soluppgång	n.
rewon	morgon	n.
srekamtrr	tiden på förmiddagen	n.
kxamtrr	middagstid, middag, tolvslaget	n.
kxamtrrmaw	tiden precis efter lunch, tidig eftermiddag	n.
ha'ngir	eftermiddag	n.
kaym	kväll (före skymning), sen eftermiddag	n.
sreton'ong	kväll före solnedgång	n.
txon'ong	skymning, solnedgång	n.
txon'ongmaw	skymning, tiden före mörkret, efter solnedgången	n.
srekamtxon	före midnatt	n.
kxamtxon	midnatt	n.
kxamtxomaw	efter midnatt	n.
sresrr'ong	före gryning	n.
wou	att vara fascinerande, otrolig (slangord)	svin.
tsyìräfì	giraff	n.
tsawa	den, det, som (bisatsmarkör)	pn., sbd.
tsata	det, den, som (klausul bisatsmarkör)	pn., sbd.
tsaria	den, det (klausul bisatsmarkör)	pn., sbd.
alo	tid, tur, ögonblick, en av ett antal återupprepande handlingar	n.
fralo	varje gång, varje ögonblick	adv.
nìmwey	lugnt, fridfullt	adv.
ku'up	tung (fysisk vikt)	adj.
syo	lätt (fysisk vikt)	adj.
hay	nästa	adj.
ham	föregående	adj.
matsa	matsa, kex	n.
hametsì	syrat bröd	n.
tìkangkemvi	projekt, en bit av ett arbete	n.
nì'i'a	till slut, äntligen	adv.
nìsyen	slutligen	adv.
pìlok	blogg	n.
tsulfätu	expert, någon som har bemästrat en konst eller färdighet	n.
tsulfä	sakkunskap	n.
tsulfä si	bemästra	vin.
numtsengvi	klassrum, del av skola	n.
rofa	längs med, bredvid, brevid	adp.
pum	en (pronomen för att modifiera substantiv eller pronomen)	pn.
Yuesey	USA	prop.n.
teya si	fylla (med dativet som fylls)	vin.
alunta	därför, av anledningen	conj.
nìprrte'	med välbehag, välkommen (antaget zola'u) gladeligen, med nöje	adv.
sngä'iyu	nybörjare	n.
srekrr	före, förr i tiden, redan	adv.
ayu	saker	n.
tsafya	på det sättet, sådär	adv.
muve	andra (ordningstal)	adj.
pxeyve	tredje (ordningstal)	adj.
tsìve	fjärde (ordningstal)	adj.
mrrve	femte (ordningstal)	adj.
puve	sjätte (ordningstal)	adj.
kive	sjunde (ordningstal)	adj.
volve	åttonde (ordningstal)	adj.
tsyänel	TVkanal	n.
trrtxon	dag och natt cykeln av Pandora	n.
au	uttryck av bestörtning	intj.
pängkxoyu	pratare, snackare	n.
lekoren	angående lagar och regler	adj.
prrkxentrrkrr	dagtidsrökandenjutning, vibrerande tunga (Na'vi idiom)	n.
tìftia	studie	n.
tìftia kifkeyä	vetenskap, studien av fysiska världen	n.
pxir	öl	n.
eanean	chealde, herbaceous växt	n.
'ele'wll	tass med törnar, kaktus	n.
tstxa'a	canalyd (växt på Pandora)	n.
pa'liwll	hästväxt	n.
anìheyu	fibonacci, blå sprialväxt	n.
tompawll	geode, regnplanta	n.
pxiwll	eremitknoppplanta	n.
syeptute	personfångare	n.
kllpxiwll	lejonbär	n.
smaoe	kraftigt törnad planta, phalanxia	n.
'ä'o	tillbringarplanta	n.
mulpxar	roosterheadplanta	n.
flefle	Solförtjusning, magnetotrophic växt	n.
kxaylte	cillaphant	n.
fkxakewll	kliplanta	n.
tìhawnuwll	skyddande planta	n.
pxorna'lor	vacker, exploderande frö planta	n.
pxayzekwä	taggig piska	n.
mìnyu	tvinnad lilja	n.
mìnyu	vändare, tvistare	n.
väfewll	illaluktande planta	n.
sngukx	larvplanta	n.
rawp	polypblåsa	n.
'ampirikx	löv tillbringarplanta	n.
apxangrr	delta träd	n.
värumut	ådrebalja	n.
keyawr	fel, inte rätt	adj.
lehrrap	farlig	adj.
tìtxen	vakenhet	n.
hìrumwll	pufferplanta	n.
fwäkì	syrsa	n.
fratxon	varje kväll	adv.
hìkrr	sekund, väldigt kort tid	n.
mawkrr	efter, efteråt	adv.
ngeyn	trött	adj.
ngopyu	skapare	n.
nìk'ong	långsamt	adv.
pamtseotu	musiker	n.
sat	det där	pn.
tsal	det, den (transitivt subjekt)	pn.
tsat	det, den (om ett föremål)	pn.
tsawlhì'	storlek	n.
lì'fyavi	uttryck, bit av språk	n.
nafì'u	sådan	adj.
lì'fyaolo'	språkanvändare, språkgrupp	n.
puktsyìp	häfte, broschyr	n.
utraltsyìp	buske	n.
säspxintsyìp	mindre krämpa	n.
'itetsyìp	lilla dotter (uttryck av ömhet)	n.
sa'nutsyìp	lilla mamma (används för unga flickor)	n.
kem si	göra	vin.
tswin	extern nervanslutning, fläta	n.
tswintsyìp	lilla fläta	n.
taronyutsyìp	lilla jägare	n.
oetsyìp	lilla jag, lilla mig	pn.
ngatsyìp	lilla du	pn.
atanvi	stråle	n.
txeptsyìp	kär eller söt liten eld	n.
tìkusar	lärande (handlingen)	n.
tìyusom	ätande (handlingen)	n.
tìtusaron	jakt	n.
tìpängkxotsyìp	liten konversation	n.
hayalo	nästa gång	adv.
hamalo	senaste gången	adv.
tstunwi	snäll, omtänksam, hänsynsfull, vänlig	adj.
seykxel	stark (emotionellt, spirituellt, inte fysiskt), självsäker	adj.
fuke	eller inte	conj.
'a'aw	några, få	adj.
'okrol	historia (uråldrig)	n.
'okvur	historia (inte uråldrig)	n.
alu	som är, med andra ord	conj.
fnawe'	fegt, feg	adj.
fnawe'tu	fegis	n.
ftxìlor	läcker, välsmakande	adj.
ftxìvä'	äcklig, inte välsmakande	adj.
fyeyn	vuxen, mogen	adj.
fyeyntu	vuxen person	n.
tìfyeyn	mognad, fullt utvecklad	n.
hawngkrr	sen	adv.
lehawngkrr	sen (att vara sen)	adj.
leye'krr	tidig	adj.
hek	vara annorlunda, konstig, oväntad, underlig	vin.
nìhek	konstigt, annorlunda	adv.
ki	utan snarare, utan istället	conj.
nìfyeyntu	som en vuxen, mogen	adv.
nì'eveng	som ett barn, omoget	adv.
lìng	hänga i luften, sväva	vin.
ram	berg	n.
muntxatu	make	n.
muntxatan	man, make	n.
muntxate	fru, maka	n.
netrìp	lyckligt, lyckligtvis	adv.
newomum	vara nyfiken, vilja veta	svin.
lenomum	nyfiken	adj.
tìnomum	nyfikenhet	n.
ngäzìk	svår	adj.
tìngäzìk	svårighet, problem	n.
nìsung	dessutom	adv.
reng	grund (fysisk)	adj.
rolun	Eureka! Jag hittade det!	intj.
sa'sem	förälder eller en upsättning föräldrar	n.
smar	byte, jagad sak	n.
starsìm	samla, samla ihop	vtr.
sunu	vara tilltalande eller sympatisk, något som ger njutning	vin.
syayvi	tur, chans	n.
nìsyayvi	av slump eller av en tillfällighet	adv.
tolel	Eureka! Jag har det! Jag förstår!	intj.
txukx	djup (fysiskt)	adj.
ve'kì	hata	vtr.
tìve'kì	hat	n.
yaymak	dåraktig, ignorant	adj.
ye'krr	tidigt	adv.
zìsìkrr	säsong, årstid	n.
zo	vara hälsosam, vara intakt, vara som det ska vara eller som naturen menat	svin.
zoslu	hela, bli bra, fixas	vin.
zeyko	hela, fixa	vtr.
frawzo	allt är bra, allt är ok	intj.
kemlì'uvi	infix	n.
irayo si	tacka, ge tack	vin.
lefkrr	aktuell, nuvarande,	adj.
lì'upam	uttal	n.
natkenong	som exempel, till exempel,	conj.
eltur tìtxen si	vara intressant, vara spännande	vin.
pxelo	tredje, tre gånger	adv.
pamrelfya	stavning	n.
law si	göra klart, förklara	vin.
tìsung	tillägg, ps.	n.
naer	dricka, något som man kan dricka	n.
atxkxerel	karta	n.
nìtengfya	som, samma sätt som (liknande handling)	adv.
tun	röd, orange	adj.
'om	violett, lila, magenta	adj.
neyn	ljusa färger, vita nyanser	adj.
ngul	grå 	adj.
tumpin	röd, orange	n.
eampin	blå, grön	n.
rimpin	gul	n.
'ompin	violett, lila, magenta	n.
layompin	svart	n.
teyrpin	vit	n.
vawmpin	mörk färg	n.
neympin	ljus färg	n.
ngulpin	grå	n.
pil	ansiktsrand	n.
ta'lengean	hudblå	adj.
rìkean	lövgrön	adj.
kllvawm	brun	adj.
'evan	pojke (vardagligt)	n.
'eve	flicka (vardagligt)	n.
'evengan	pojke	n.
'evenge	flicka	n.
fkio	tetrapteron, flamingoliknande fågel	n.
kenten	fan lizard, ödla	n.
nìwä	tcärtom	adv.
pìwopx	moln	n.
ramtsyìp	kulle	n.
syaksyuk	prolemuris	n.
tor	sista, ultimata, slutgiltiga	adj.
txärem	ben (som skelett)	n.
uk	skugga	n.
yapay	dimma, imma	n.
tìspe'e	fånge	n.
tìftxavang	passion	n.
tìtstunwi	vänlighet	n.
stxeli	gåva, present	n.
ngrrpongu	gräsröttersrörelse	n.
smon	känna till, känna	vin.
lawk	samtala om, prata om, säga något angående	vtr.
hìtxoa	ursäkta mig,	intj.
mäkxu	avbryta, störa, kasta ut ur en harmonisk balans 	vtr.
hultstxem	hindra	vtr.
mok	föreslå	vtr.
muwìntxu	introducera, presentera	vtr.
kan'ìn	fokusera på, specialisera i, vara särskilt intresserad av	vtr.
tìwusem	kamp	n.
nì'eng	lika, på samma nivå	adv.
Pari	Paris	prop.n.
tì'ong	blommning	n.
tìmok	förslag	n.
tì'em	matlagningskonst, konsten att laga mat	n.
leyn	repetera, göra igen	vtr.
päsketpol	basket	n.
nìFranse	Franska, på Franska	adv.
nìToitsye	Tyska, Deutsch	adv.
nìno	i detalj, grundligt	adv.
hìno	detaljerad, precis (om saker)	adj.
leno	grundlig, fokuserad på detaljer (om en person)	adj.
tìno	grundlighet, uppmärksamhet på detaljer	n.
'ongokx	födas	vin.
nokx	föda	vtr.
nìtrrtrr	dagligen, regelbundet	adv.
tìn	aktivitet som håller en upptagen	n.
txin	främst, primär	adj.
txintìn	yrke, roll i samhället	n.
'emyu	kock	n.
vewng	se efter, ta hand om, vara ansvarig för	vtr.
kaltxì si	häsla, säga hej	vin.
sopyu	resande, resenär	n.
fula	den, det, som (klausul bisatsmarkör)	pn., sbd.
tskxekeng si	öva, träna	vin.
way si	sjunga	vin.
swawtsyìp	litet ögonblick, sekund	n.
käteng	spendera tid med, hänga med	vin.
'ìn	vara upptagen, vara sysselsatt	svin.
Sweriye	Sverige	prop.n.
nìfkrr	nyligen, för närvarande	adv.
sulìn	vara upptagen (på ett positivt sätt): hålla på med något som anses vara särskilt roligt och njutbart	svin.
vrrìn	vara upptagen (på ett negativt sätt): vara trött på en aktivitet som man är upptagen med	svin.
tìk'ìn	fritid, frånvaro av arbete	n.
säsulìn	hobby, nöjesaktivitet	n.
'o'	roligt, spännande	adj.
Europa	Europa	prop.n.
skxaypxe	Skype	n.
pxorpam	ejektiv konsonant	n.
tì'o'	kul, spänning	n.
nì'o'	på ett sätt som är njutbart eller behagligt	adv.
fnan	vara bra på	vtr.
wätx	vara dålig på	vtr.
tìsom	hetta, värme	n.
tìwew	kyla	n.
tìlen	händelse, event	n.
nìnäk	av drickande, genom drickande	adv.
nìhay	nästa	adv.
sayrìp	snygg, stilig (används vanligtvis för män)	adj.
letokx	kroppslig, fysisk	adj.
säzärìp	träns, tyglar	n.
ìpxa	ormbunke	n.
tìhawnu si	skydda	vin.
sno	hans eget, hennes eget, dens eget (reflextiv, genitivform sneyä)	pn.
kìte'e si	tjäna, betjäna, stå till tjänst	vin.
var	att fortsätta utföra en handling, att kvarstå i ett läge	vim.
nìftxan	så, i sådan utsträckning	adv.
Yeysu	Jesus	prop.n.
lelì'fya	angående språk, språkligt	adj.
takrra	sen, sedan (dess)	conj.
akrrta	sen, sedan (dess)	conj.
few	över, med sikte på andra sidan	adp.
fewtusok	motsats, på andra sidan	adj.
sla'tsu	beskriva	vtr.
tìsla'tsu	beskrivning	n.
'en	gissning, intuition, känsla, magkänsla	n.
'en si	gissa	vin.
le'en	intuitiv, fundersam (om en handling, inte en person)	adj.
nì'en	gissandes, agerar på sin magkänsla	adv.
sä'o	redskap, verktyg	n.
pamtseo si	spela musik (med fa för instrumentet som spelas)	vin.
väng	törstig	adj.
tìväng	törst	n.
sngum	oro	n.
nìsngum	oroande, upprörande	adv.
yayayr	förvirring	n.
wäte	gräla, diskutera	vtr.
tìwäte	gräl, bråk	n.
säwäte	grunden till gräl, källa till argument	n.
lewäte	debattslysten, omedhållande	adj.
nìwäte	motvilligt, omedhållande	adv.
li	redan	adv.
lisre	fram tills, före	adp.
ronsrelngop	föreställa sig, visionera (sammansättn. ronsem sinne, rel bild, ngop skapa, vardagligt uttal [Ron.sREw.Nop] )	vtr.
ronsrel	något påhittat, något fantiserat	n.
tìronsrel	fantasi, föreställningsförmåga	n.
txanatan	ljus, stark, intensivt (ljus)	adj.
leronsrel	påhittad, imaginär	adj.
nìronsrel	genom att föreställa sig, föreställandes	adv.
srefey	förvänta sig, förvänta, vänta sig	vtr., vin.
mawl	halva	n.
pan	tredjedel	n.
wan	gömma, dölja	vtr.
nìwan	hemlighetsfullt, i hemlighet	adv.
tìwan	mörkläggning	n.
letwan	mystisk, lurig, skum, lömsk (om en person)	adj.
slele	simma	vin.
nìslele	genom att simma, simmandes	adv.
tìtaron	jakt	n.
ìì	öhh, ehh	intj.
tsukyom	ätbar	adj.
ketsuktswa'	oförglömlig, minnesvärd	adj.
tsuktswa'	lätt glömd, glömbart	adj.
yafkeyk	väder	n.
fkeytok	existera 	vin.
tìfkeytok	situation, tillstånd	n.
tompameyp	duggregn	n.
tskxaytsyìp	hagel	n.
tskxepay	is	n.
herwì	snö	n.
tomperwì	snöblandat regn, slask	n.
txanfwerwì	snöstorm	n.
hermeyp	snöyra, lätt snöfall	n.
hertxayo	snöfält	n.
ìlva	flinga, droppe, bit	n.
txepìva	aska	n.
herwìva	snöflinga	n.
payìva	vattendroppe	n.
tompìva	regndroppe	n.
kintrr	vecka	n.
mrrtrr	arbetsvecka, femdagarsvecka	n.
muntrr	helg	n.
kintrram	förra veckan	n.
kintrray	nästa vecka	n.
muntrram	förra helgen	n.
muntrray	nästa helg	n.
vospxì	månad	n.
vospxìam	förra månaden	n.
vospxìay	nästa månad	n.
sweylu	borde, bör, skulle	v.
ye	nöjd, belåten	adj.
hasey si	slutföra, göra färdigt	vin.
seysonìltsan	bra jobbat! (härstammar ifrån hasey soli nìltsan väl slutfört)	intj.
yehakx	mätt, belåten (angående mat)	adj.
yeväng	belåten (angående dryck), släckt törst	adj.
somwew	temperatur	n.
pup	kort (fysiskt)	adj.
ngimpup	längd, sträcka	n.
pesomwew	vilken temperatur?	inter.
somwewpe	vilken temperatur? (vardagligt)	inter.
txawew	väldigt kall	adj.
wur	sval, kylig	adj.
tsyafe	mild, behaglig	adj.
sang	varm	adj.
txasom	väldigt het, väldigt varm	adj.
leyapay	dimmigt, disig	adj.
lepwopx	molnig	adj.
nìhol	några, inte många	adv.
nìpxay	många	adv.
paynga'	fuktig	adj.
meuianga'	hederlig, ärofull	adj.
txumnga'	giftig	adj.
'akra	jord (bördig)	n.
hufwetsyìp	vindpust, bris	n.
nìlam	uppenbarligen, tydligen	adv.
nìli	i förväg	adv.
nìfrakrr	som vanligt, som alltid	adv.
am'a	tvekan	n.
nga'	innehålla	vtr.
tìftang si	sluta	vin.
may'	pröva, testa, prova på	vtrm.
yora'	vinna	vtr.
snaytx	förlora	vtr.
tìyora'	vinst	n.
tìsnaytx	förlust	n.
'otxang	musikinstrument (allmänt begrepp)	n.
skxir	sår	n.
leskxir	sårad, skadad	adj.
skxir si	skada, såra	vin.
skxirtsyìp	skärsår, blåmärke, litet sår	n.
sloan	hälla upp	vtr.
emrey	överleva	vin.
temrey	överlevnad	n.
lemrey	överlevande	adj.
nemrey	på ett sätt som om ens liv står på spel	adv.,intj.
wawe	betydelse, mening	n.
txanwawe	meningsfull, betydande	adj.
nìwawe	meningsful, betydande	adv.
keyrel	ansiktsuttryck	n.
fwampop	tapirus	n.
säplltxe	uttalande	n.
säplltxevi	kommentar	n.
kawtseng	ingenstans	adv.
tsapo	den där (endast om personer)	pn.
fwefwi	vissla	vin.
'etnaw	axel	n.
pllngay	erkänna	vin.
kawngsar	utnyttja	vtr.
lom	saknad (för en frånvarande person)	adj.
koaktan	gammal man	n.
koakte	gammal kvinna	n.
koaktu	gammal person	n.
lomtu	saknad person	n.
fe'	dålig	adj.
nìfe'	dåligt	adv.
wätu	motståndare	n.
fekem	olycka	n.
hawtsyìp	tupplur	n.
uran	båt	n.
ftxozä si	fira	vin.
kekem	ingen aktivitet eller handlig	pn., adv.
pxen	klädesplagg	n.
tewng	höftskynke	n.
raspu'	leggings (används i krig)	n.
hawnven	sko	n.
hawntsyokx	handske	n.
hawre'	hatt	n.
ioi	utsmyckning, ceremoniell utsmyckning	n.
nìlun	så klart, naturligtvis, givetvis, enligt sunt förnuft	adv.
'ali'ä	halsband	n.
'are	poncho, sjal, cape	n.
fkxile	halsband (stort)	n.
masat	bröstplåt (rustning)	n.
nikroi	hårutsmyckning	n.
pxawpxun	armband	n.
renten	skydsglasögon, (gjorda av insektsvingar, täljda ur trä, etc)	n.
tsamopin	krigsfärg	n.
tsang	piercing	n.
miktsang	örhänge	n.
ontsang	näsring, näspiercing	n.
yemstokx	klä på, ta på (kläder)	vtr.
ioi si	smycka, utsmycka	vin.
'aku	ta av, klä av, ta bort	vtr.
le'aw	enda	adj.
mawkrra	efter (tid)	conj.
akrrmaw	efter (tid)	conj.
Toitslan	Tyskland	prop.n.
Toitsye	tysk	adj.
lukpen	utan kläder, naken	adj.
fmawnta	nyheter som	n.
vin	be om, be	vtr.
mìftxele	angående det här, i detta avseende	adv.
zìma'uyu	nykomling, någon som just anlänt	n.
nìvingkap	apropå, förresten	adv.
txankrr	under en lång tid, för en lång tid	adv.
vingkap	inse, komma på	vtr.
tìomum	kunskap	n.
tinan	läsning	n.
ninan	via läsning	adv.
tsmìm	djurspår	n.
inan	läsa (tex. skogen), få kunskap ifrån sinnesintryck	vtr.
'ä'	oj!, ups!	intj.
teynga	svar som	n.
teyngla	svar som (subjekt)	n.
teyngta	svar som (objekt)	n.
fayluta	de här orden som	n.
stxenu	erbjudande, offer	n.
tìtstew	mod, tapperhet	n.
tìtstewnga'	modig, tapper	adj.
stxenutìng	erbjuda, offra	vtr.
tsyär	neka, avvisa	vtr.
tìtsyär	avslag	n.
mll'an	acceptera	vtr.
tìmll'an	accepterande, acceptans	n.
kam	sedan	adp.
kay	från och med nu (i framtiden)	adp.
'awnìm	undvika	vtr.
steng	liknande	adj.
nìsteng	liknande, på samma sätt	adv.
nim	blyg	adj.
srätx	störa, irritera	vtr.
säsrätx	irritation	n.
rì'ìr	avspegling, reflektion	n.
rì'ìr si	reflektera, imitera	vin.
tsìsyì	viska	vin.
nìwok	högt, högljutt	adv.
sätsìsyì	viskning	n.
nìtsìsyì	viskande, i en viskning	adv.
nìfwefwi	visslande, visslandes	adv.
lawr	melodi	n.
tìng lawr	nynna, sjunga utan ord	vin.
säomum	information	n.
kosman	fantastisk, underbar	adj.
nìksman	underbart	adv.
letsim	originell, unik, härstammar inte ifrån en annan källa	adj.
lesngä'i	ursprunglig, exsisterande från början, den första i en serie	adj.
nìtsim	originellt, på ett originellt sätt	adv.
nìsngä'i	ursprungligen, i början	adv.
ngong	lat, slö, brist på nödvändig energi	adj.
walak	energisk, aktiv	adj.
tìngong	lättja, lathet	n.
txi	brådska	n.
letxi	stressad	adj.
nìtxi	stressat, hastigt	adv.
letxiluke	stressfri, lugn	adj.
nìtxiluke	utan brådska, lugnt	adv.
kulat	avslöja, lägga fram, avtäcka (bokstavligt och metaforiskt)	vtr.
txantompa	regnstorm	n.
meyam	krama, omfamna, hålla i sin famn	vtr.
sämyam	kram, omfammning	n.
fìtsap	varandra	adv.
nuä	bortom	adp.
kanfpìl	koncentrera sig, fokusera sin uppmärksamhet	vin.
fmokx	avundjuka, avund	n.
nìfmokx	avundsjukt	adv.
kìmar	i säsong (om mat, grönsaker och djur)	adj.
nìkmar	lägligt, i rätt säsong	adv.
nìngong	lat, lättjefullt	adv.
säpom	kyss, puss	n.
kxukx	svälja	vtr.
txewm	läskig, skrämmande	adj.
hìmpxì	minioritet, liten del	n.
nutx	tjock	adj.
flì	tunn (inte för människor)	adj.
flìnutx	tjocklek	n.
säsyep	fälla	n.
yora'tu	vinnare	n.
snaytu	förlorare	n.
ultxatu	mötesdeltagare	n.
wo	sträcka sig efter	vtr.
yawo	starta, sätta igång	vin.
tsìk	plötsligt, utan förvarning	adv.
syor	slappna av, chilla	vin.
tìsyor	avslappning	n.
tìfnunga'	tyst	adj.
'anla	längta efter	vtr.
sä'anla	längtan	n.
lie	erfarenhet	n.
tsìlpey	hopp (abstrakt idé)	n.
kelsar	onödig, värdelös	adj.
yì	hylla, avsats, steg, nivå	n.
snayì	trappa, serie av trappliknande nivåer	n.
kxaylyì	hög nivå	n.
kxamyì	mittimellannivå	n.
tìmyì	låg nivå	n.
