"Frontside"	"Flipside"	"Category"
'ampi	трогать	vtr.
'angtsìk	молотоглав (животное)	n.
'aw	один	num.
'awkx	утёс	n.
'awpo	одна персона	pn.
'awsiteng	вместе	adv.
'awve	первый	adj.
'e'al	худший	adj.
'eko	нападать, атаковать	vtr.
'ekong	ударный ритм	n.
'engeng	уровень, этаж	adj.
'eveng	ребёнок	n.
'evi	дитя (affectionate form of)	n.
'ewan	молодой	adj.
'eylan	друг	n.
'ì'awn	оставаться, сохранять состояние	vin.
'ìheyu	спираль	n.
'Ìnglìsì	английский язык	n.
'it	кусочек, частица, небольшое количество	n.
'itan	сын	n.
'ite	дочь	n.
'ok	память, воспоминания	n.
'ong	раскрываться, распускаться, цвести, процветать	v.
'u	вещь	n.
'upe	что за, какой, который	inter.
'upxare	сообщение, послание, обращение	n.
a	который (в аттрибутивной конструкции связывает определяемое с определяемым)	part.
alaksi	готовый	adj.
lìm	отдаляться, быть далеко	svin.
apxa	большой, крупный	adj.
atan	свет	n.
atokirina'	семя священного дерева	n.
atxkxe	земля, местность	n.
au	барабан из кожи	n.
aungia	знак, знамение	n.
awaiei	райский банши	n.
awnga	мы	pn.
ayfo	они	pn.
aynga	вы (инклюзив)	pn.
ayoe	мы (эксклюзив)	pn.
ayoeng	мы (инклюзив)	pn.
äie	способность Видеть (духовный смысл)	n.
äo	под 	adp.
ätxäle	просьба, мягкое требование	n.
ätxäle si	просить, мягко требовать	vin.
ean	синезеленый	adj.
eltu	мозг	n.
eltu si	слушать, обратить внимание, перестать дурить	vin.
eltungawng	мозговой червь	n.
emza'u	сдать (экзамен, тест), пройти испытание	vtr.
eo	впереди, спереди, перед	adp.
eyawr	верный, правильный	adj.
eyaye	«Боевые перья»	n.
eyk	вести, быть проводником, руководить	vtr.
eyktan	вождь, предводитель	n.
fa	чемлибо, посредством чеголибо	adp.
fahew	запах	n.
fìfya	подобно этому, таким образом	adv.
fìkem	это (действие или поступок)	pn.
fìpo	этот (указание на одушевленный или неодушевленный предмет	pn.
fìtxan	настолько (степень выраженности)	adv.
fìtseng	тут, здесь, в этом месте	adv., n.
fìtsenge	тут, здесь, в этом месте	adv., n.
fì'u	этот (с неодуш. предметом)	pn.
fkarut	сдирать, соскабливать, чистить	v.
fkew	сильный, могущественный, могучий	adj.
fko	обобщенноличное местоимение	pn.
flä	достигать цели, преуспевать, иметь успех	vin.
fmawn	новость, предмет сообщения	n.
fmetok	экзаменовать, подвергать испытанию	vtr.
fmi	пробовать, пытаться	vtrm.
fngap	металл	n.
fngapsutxwll	Pennanemone ciliare («растение, следующее за металлом»)	n.
fnu	молчать, замолкать	vin.
fo	они (сокращенная форма)	pn.
fpak	приостанавливать, откладывать (какоелибо дело)	v.
fpe'	отправлять, посылать	vtr.
fpeio	вызов (церемониальный)	n.
fpi	ради, изза, для, с целью	adp.
fpìl	думать	vtr.
fpom	мир, благополучие	n.
fpxafaw	медуза	n.
fpxäkìm	входить, проникать, попадать	vin.
fra'u	всё	pn.
frakrr	всегда	adv.
frapo	все	pn.
frrfen	навещать, посещать	vtr.
frrtu	гость	n.
ftang	прекращать, останавливаться	vim.
fte	чтобы, для того чтобы	conj.
fteke	чтобы не, как бы не	conj.
ftia	изучать, учить	vtr.
ftxì	язык (часть тела)	n.
ftxozä	праздник	n.
ftu	от, из, с (направление в пространстве)	adp.
ftue	легкий, простой, нетрудный	adj.
ftxavang	пылкий, страстный	adj.
ftxey	выбирать	vtr.
fu	или	conj.
futa	что, чтобы	pn., sbd.
fwa	тот (который или что) (маркер относительного выражения)	pn., sbd.
fya'o	путь, дорога	n.
fyape	как	inter.
fyawìntxu	вести, направлять	vin.
ha	так что, в таком случае	adv.
hahaw	спать	vin.
hapxì	часть	n.
hasey	готовый, законченный, завершенный	adj.
hawnu	охранять, защищать, укрывать	vtr.
hì'i	маленький (в размере)	adj.
hiyìk	смешной, забавный, странный	adj.
hol	несколько, немного	adj.
holpxay	число	n.
hrrap	опасность	n.
hu	вместе с	adp.
hufwe	ветер	n.
hum	отправляться, уходить, покидать	vin.
i'en	струнный муз. инструмент	n.
ikran	горный банши	n.
ikranay	лесной банши	n.
ioang	зверь, животное	n.
irayo	спасибо	n., intj.
ìlä	посредством чеголибо, сквозь, через, согласно чемуто	adp.
ka	через (направление)	adp.
kä	идти, ехать, двигаться	vin.
kali'weya	вид ядовитых паукообразных	n.
kalin	сладкий	adj.
kaltxì	привет	intj.
kämakto	выезжать, выдвигаться	v.
kame	видеть сущность, понимать, знать	vtr.
kan	целиться	vtrm., vtr.
kangay	действенный, эффективный, действующий	adj.
kar	учить	vtr.
karyu	учитель	n.
kato	ритм	n.
kawkrr	никогда	adv.
kawng	плохой, дурной, злой	adj.
kawtu	никто	pn.
ke	не	adv.
ke'u	ничего, ничто	pn.
kehe	нет	part., intj.
kelku	дом	n.
kelku si	жить, обитать	vin.
kem	действие, поступок	n.
kempe	что (вопрос к действию)	inter.
kenong	иллюстрировать (на примере), приводить пример, представлять в качестве образца	vin.
kerusey	мертвый	adj.
ketuwong	чужой, чужак, чужестранец	n.
kewong	чужой	adj.
keye'ung	безумие, умопомешательство	n.
kifkey	материальный мир	n.
kilvan	река	n.
kìm	вращать (чтолибо)	vtr.
kin	нуждаться (в комто или чемто)	vtr.
kinam	нога	n.
kinamtil	колено	n.
kìng	нить	n.
kip	между, посреди, среди	adp.
kìte'e	служба, занятие, работа, услуга	n.
kllfro'	нести ответственность	svin.
kllkulat	прокапывать	vtr.
kllkxem	стоять	vin.
kllpxìltu	территория	n.
kllte	земля	n.
ko	призыв к действию, побуждение к согласию	part.
kop	также, в том числе	adv.
koren	правило	n.
krr	время	n.
krrnekx	требовать времени	vin.
krrpe	когда (в какое время)	inter.
kunsìp	ударный вертолёт	n.
kurakx	выезжать, выдвигаться откудалибо	vtr.
kxam	середина, центр	n.
kxamtseng	место посередине	n.
kxangangang	бабах (звукоподражание)	intj.
kxanì	запрещённый, запретный	adj.
kxawm	может быть, возможно	adv.
kxener	дым	n.
kxetse	хвост	n.
kxeyey	ошибка	n.
kxll	нападать, бросаться в атаку	n.
lahe	другой, иной	adj.
lam	казаться, представляться	vin.
lapo	другой (вещь или персонаж)	pn.
latem	меняться, менять	vin.
law	ясный, четкий, определенный	adj.
lefpom	мирный, добрый, умиротворенный, веселый	adj.
lertu	коллега	n.
letrr	ежедневный, каждодневный	adj.
letsunslu	возможный, вероятный	adj.
lì'u	слово	n.
lì'fya	язык (речь)	n.
lok	подходить, приближаться	vtr.
lonu	освобождать, отпускать, выпускать	vtr.
lor	красивый, привлекательный	adj.
loreyu	helicoradium spirale, прекрасная спираль	n.
lrrtok	улыбка	n.
lrrtok si	улыбаться	vin.
lu	быть, являться, существовать	vin., svin.
lun	причина	n.
lumpe	почему, зачем	inter.
ma	маркер звательного падежа	part.
makto	ехать (верхом)	vtr.
mawey	спокойный	adj.
mefo	они (указание на пару коголибо или чеголибо)	pn.
menari	глаза	n.
meoauniaea	гармония жизни с природой	n.
meuia	слава, почёт, честь	n.
meyp	слабый, неспособный, хрупкий	adj.
mi	все ещё, пока что, попрежнему	adv.
mip	новый	adj.
mikyun	ухо	n.
mì	в, на	adp.
mìn	поворот	vin.
mìso	далеко, вдали (позиция)	adv.
mllte	соглашаться	vin.
moe	мы двое (без собеседника)	pn.
mokri	голос	n.
muiä	правильный, должный, справедливый	adj.
mun'i	резать, разрезать	v.
mune	два	num.
munge	брать, нести	vtr.
mungwrr	кроме	adp.
muntxa	сочетавшиеся браком	adj.
na	как и, подобно	adp.
na'rìng	лес	n.
Na'vi	на'ви (Народ, разумные аборигены Пандоры)	prop.n.
nang	восклицание удивления, восхищения 	part.
nantang	змееволк Caniferratus costatus, бронированный волк	n.
nari	глаз	n.
nari si	быть начеку, смотреть в оба	vin.
nawm	великий, славный, благородный	adj.
ne	к, по направлению к	adp.
ne'ìm	назад, обратно	adv.
nekx	потреблять, расходовать	vtr.
neto	от (по направлению)	adv.
new	хотеть, желать	vtrm.
niä	брать, хватать	vtr.
nì'aw	только, лишь, исключительно	adv.
nìawnomum	как известно (прост. [naw.no.mum])	adv.
nì'awtu	в одиночестве	adv.
nì'awve	впервые	adv.
nì'it	чутьчуть, немного (абстрактно)	adv.
nì'ul	более	adv.
nìayoeng	как мы, подобно нам (прост. [naj.wEN])	adv.
nìftue	просто	adv.
nìftxavang	страстно, пылко, с душой	adv.
nìhawng	излишне, слишком, чересчур, чрезмерно	adv.
nìltsan	хорошо	adv.
nìmun	ещё, вновь, опять	adv.
nìn	взглянуть на чтолибо, посмотреть кудалибо	vtr.
nìngay	правдиво, искренне, в самом деле	adv.
nìtam	довольно, достаточно	adv.
nìteng	также, в том числе	adv.
nìtut	ежеминутно, непрерывно, всё время	adv.
nìtxan	весьма, очень, сильно	adv.
nìwin	быстро 	adv.
nìwotx	целиком, всецело, полностью	adv.
nulkrr	дольше	adv.
nulnew	отдавать предпочтение, предпочитать	vtrm.
nume	учиться, изучать	vin.
nga	ты	pn.
ngawng	червь	n.
ngay	верный, правильный, правдивый	adj.
ngenga	ты (уважительная форма)	pn.
ngim	длинный	adj.
ngop	создавать, творить, порождать	vtr.
ngrr	корень	n.
nguway	вой, крик змееволка	n.
oe	я	pn.
oeng	мы с тобой (двойственный инклюзив)	pn.
oeyk	причина	n.
ohe	я (почтительная или церемониальная форма)	pn.
olo'	клан	n.
olo'eyktan	вождь клана	n.
omum	знать, понимать, разбираться	vtr.
ontu	нос	n.
pähem	прибывать, приезжать, достигать	vin.
pak	всегото! (выражение досады или разочарования)	part.
pa'li	лошадь (direhorse)	n.
palulukan	Танатор (крупный хищник)	n.
pam	звук	n.
pamtseo	музыка	n.
pamtseowll	«кошачье ухо», музыкальный цветок	n.
pängkxo	вести беседу, разговаривать (ни с кем конкретно)	vin.
pänutìng	обещать (комуто) 	vtr.
pätsì	эмблема, символ, знак	n.
pawm	просить, спрашивать	v.
pay	вода	n.
paywll	дапофет («водное растение», названо так изза мясистых сочных листьев, в которых накапливает влагу из почвы)	n.
pe	вопросительный маркер	affix
pe'un	решать	vtr.
pefya	как	inter.
pehem	прямой вопрос к какомулибо действию, поступку	inter.
pehrr	когда, в какое время	inter.
pelun	зачем, почему, отчего	inter.
peng	сообщить, рассказать	vtr.
penghrrap	«маяк опасности» (издающее изумруднофиолетовый цвет при приближении опасности растение)	n.
peseng	где	inter.
pesu	кто	inter.
peu	кто (вопрос к неодушевленному предмету)	inter.
pey	ждать, ожидать	vin.
pizayu	прародитель, предок	n.
plltxe	говорить, изъясняться	v.
po	он, она	pn.
poan	он	pn.
poe	она	pn.
pongu	группа, отряд, команда	n.
prrnen	малыш	n.
prrnesyul	почка	n.
prrte'	довольный (от действия)	adj.
pxan	достойный, заслуживающий, стоящий	adj.
pxasìk	да катись оно всё!, пропади оно пропадом!	intj.
pxasul	свежий, аппетитный	adj.
pxay	многие, много	adj.
pxey	три	num.
pxi	острый (форма)	adj.
pxìm	часто	adv.
pxiut	«пальмабритва» (дерево с заостренными по краю жесткими листями и чешуйками ствола)	n.
pxorna'	(букв. «взрыв семян») эписот, растение, зрелые плоды которого лопаются, разбрасывая покрытые липкой слизью семена)	n.
pxun	рука	n.
pxuntil	локоть	n.
rä'ä	не (с глаголом как приказ не совершать действие)	part.
ral	значение, смысл	n.
ralpeng	объяснять, толковать, переводить	vtr.
rawke	клич тревоги, призыв к защите	intj.
rel	картинка, изображение	n.
reltseo	изобразительное искусство, умение рисовать	n.
reltseotu	художник	n.
renu	узор	n.
rey	жить, существовать	vin.
rikx	двигаться, шевелиться, перемещаться	vin.
rim	жёлтый	adj.
rina'	семя	n.
riti	стингбат (мелкий летающий хищник с жалом на хвосте)	n.
rol	петь	v.
ronsem	ум, разум	n.
rum	шар	n.
rumut	«дерево шаров» (плоды дерева имеют вид шаров и наполнены газовой смесью, включающей водород, благодаря чему могут после созревания отрываться и улетать. Взрыв плода рассеивает семена дерева)	n.
run	обнаруживать, раскрывать, находить	vtr.
rutxe	пожалуйста	intj.
sa'nok	мать	n.
sa'nu	мама (affectionate form of)	n.
san	маркер начала цитирования речи	adv.
sänume	обучение, преподавание	n.
säspxin	болезнь, слабость	n.
sempu	папа (affectionate form of)	n.
sempul	отец	n.
set	сейчас	adv.
sevin	красивый, милый	adj.
seyri	губа	n.
seze	голубой цветок	n.
si	вспомогательный глагол, постпозиционный несвязный глагол делать	
sì	и (connects two things, can be attached as --sÃ¬: for clauses use)	conj.
sìk	маркер конца цитируемой речи в высказывании	adv.
sìlpey	надеяться	vin.
sìlronsem	хитроумный, разумный (о вещи)	adj.
sìltsan	хороший	adj.
ska'a	уничтожать, разрушать	vtr.
skxawng	придурок, болван	n.
slä	но	conj.
slu	становиться	vin.
sngä'i	начинаться	vim.
sngä'ikrr	время начала	n.
sngel	мусор, отходы	n.
sngeltseng	свалка для мусора, место для выброса отходов	n.
snumìna	плохо соображающий, недалёкий	adj.
som	горячий	adj.
somtìlor	«огненная красота»	n.
spaw	верить	vtr.
spxam	гриб	n.
spe'e	захватывать, завладевать	vtr.
spe'etu	пленник, пленный	n.
spxin	больной	adj.
srak	маркер вопросов, требующих ответа «да» или «нет»	part.
srake	маркер вопросов, требующих ответа «да» или «нет»	part.
srane	да	part., intj.
srew	танцевать	vin.
srung	поддержка, помощь, содействие	n.
stawm	слышать	vtr.
steftxaw	рассматривать, осматривать, изучать, обследовать	vtr.
stum	почти	adv.
sutx	загнать в западню	vtr.
swaw	момент, мгновение	n.
swey	лучший	adj.
swirä	создание, существо	n.
swizaw	стрела	n.
swok	священный	adj.
swotu	священное место	n.
syaw	звать, окликать, обращаться, называть	vin.
syulang	цветок	n.
ta	от (пространственные отношения), от (исходный момент)	adp.
ta'em	сверху	adv.
tafral	следовательно	adv.
täftxu	плести, ткать	vtr.
täftxuyu	ткач	n.
takuk	ударять, наносить удар	vtr.
talioang	штормбык	n.
talun	поэтому, по этой причине	conj.
taluna	поэтому, по этой причине	conj.
tam	довольно, достаточно, хватит	vin., intj.
tam tam	междометие, передающее просьбу успокоиться	intj.
tangek	ствол дерева	n.
tanhì	звезда	n.
taron	охотиться	vtr.
taronyu	охотник	n.
tautral	«небесное дерево»	n.
taw	небо	n.
taweyk	поэтому, по причине	conj.
taweyka	поэтому, по причине	conj.
tawsìp	воздушное судно	n.
tawng	наклониться, пригнуться	vin.
tawtsngal	панопира («небесная чаша»)	n.
Tawtute	землянин, «небесная персона»	prop.n.
te	используется в именах	part.
tel	получать, принимать	vtr.
telem	верёвка, шнур	n.
teng	похожий, подобный	adj.
tengfya	как и, подобно тому как, тем же образом	conj.
tengkrr	пока, в то же время	conj.
teri	смысловое выделение предмета сообщения («что касается...»)	adp.
terkup	умирать	vin.
teswotìng	дарить, даровать, предоставлять	vtr.
teya	полный	adj.
teylu	личинка жука (фауна Пандоры)	n.
tewti	ого!, ух ты!, выражение приятного удивления	intj.
til	подвижное соединение, дверная петля, сустав	n.
tirea	дух, душа	n.
tireafya'o	духовный путь	n.
tireaioang	животноедух	n.
tireapängkxo	общаться интимно	v.
tì'eyng	ответ	n.
tìfmetok	проверка, испытание, тест	n.
tìftang	остановка, прекращение	n.
tìfyawìntxu	руководство, наставление	n.
tìhawnu	защита, охрана	n.
tìkangkem	работа, дело	n.
tìkawng	зло, вред, ущерб, несчастье	n.
tìkenong	пример	n.
tìkin	необходимость, надобность, нужда	n.
tìlor	красота	n.
tìng	давать	vtr.
tìng mikyun	слушать	vin.
tìng nari	смотреть	vin.
tìngay	правда	n.
tìpawm	вопрос	n.
tìran	идти, ходить пешком	vin.
tìyawn	любовь	n.
tìrey	жизнь	n.
tìrol	песня	n.
tìspxin	болезнь (как состояние)	n.
tìtxur	сила, мощность, мощь	n.
to	маркер сравнения чем (действует как предлог)	part.
tok	пребывать гделибо, занимать место	vtr.
toktor	доктор	n.
tokx	тело	n.
tompa	дождь	n.
toruk	большой леоноптерикс, «последняя тень»	n.
toruk makto	наездник большого леоноптерикса	n.
torukspxam	«октогриб», гриб большого леоноптерикса	n.
trr	день	n.
trram	вчера	adv.
tukru	копьё	n.
tul	бежать, бегать	vin.
tung	позволять, разрешать	vtr.
tupe	кто, который	inter.
tut	побуждение собеседника к высказыванию	part.
tute	персона (на'ви или человек)	n.
tuté	женщина	n.
tutan	мужчина	n.
tsa'u	то, тот (объект), та (вещь)	dem.
tsaheylu	нейросвязь (между на'ви и живым миром)	n.
tsakem	указание на действие	dem.
tsakrr	тогда, в то время	adv.
tsam	война	n.
tsampongu	отряд воинов	n.
tsamsiyu	воин	n.
tsap'alute	извинение, прощение	n.
tsatseng	тут, здесь (указание на место)	dem., n.
tsatu	этот (указание на землянина или на'ви)	dem.
tsawke	солнце	n.
tsawl	большой, высокий, крупный по телосложению	adj.
tsawlapxangrr	«высокий большой корень»	n.
tse'a	видеть, смотреть (зрительное ощущение)	vtr.
tseng	место	n.
tsenge	место	n.
tsengpe	где	inter.
tseo	искусство	n.
tskalep	арбалет	n.
tsko	лук (оружие)	n.
tsko swizaw	лук и стрелы	n.
tskxe	камень	n.
tskxekeng	обучение, воспитание, тренировка	n.
tslam	понимать	vtr.
tsleng	поддельный, неверный, неправильный, ошибочный	adj.
tslolam	понятно, ясно (в качестве реплики)	intj.
tsmuk	брат или сестра	n.
tsmuktu	братство	n.
tsmukan	брат	n.
tsmuke	сестра	n.
tsnì	это (служебное слово)	sbd.
tsngal	чаша, бокал, кубок	n.
tspang	убивать, лишать жизни	vtr.
tsranten	иметь значение, значить, быть значимым	vin.
tstew	мужественный, отважный, смелый, храбрый	adj.
tstxo	имя	n.
tsun	мочь, быть в состоянии, быть способным	vim.
tswayon	лететь	vin.
tsyal	крыло	n.
tsyo	мук\\'а	n.
tsyorina'wll	цикада, растение из семени которого добывают муку	n.
txan	большой, сильный, обильный, многочисленный	adj.
txantsan	превосходный, великолепный	adj.
txantslusam	мудрый	adj.
txe'lan	сердце	n.
txele	предмет (обсуждения или разговора)	n.
txen	бодрствующий, не спящий, проснувшийся	adj.
txep	огонь, пламя	n.
txewk	дубина (оружие)	n.
txey	останавливаться, прекращать	v.
txìm	зад, задняя часть	n.
txìng	покидать, оставлять, бросать	vtr.
txll'u	хукагурд	n.
txo	если	conj.
txoa	прощение	n.
txokefyaw	если не, иначе, а не то, в противном случае	conj.
txon	ночь	n.
txopu	страх	n.
txula	строить, сооружать	vtr.
txum	яд, отрава	n.
txumpaywll	«скорпионий чертополох», ядовитое водяное растение	n.
txumtsä'wll	«склоняющаяся фляжка», брызгающее ядом растение	n.
txur	сильный, крепкий, здоровый	adj.
ulte	и (в сложносочинительных предложениях)	conj.
ultxa	встреча, собрание	n.
unil	сон, сновидение	n.
uniltìrantokx	аватар (только тело)	n.
uniltìranyu	аватар (под контролем оператора), сноходец	n.
utral	дерево	n.
uvan	игра	n.
uvan si	играть	vin.
vay	вплоть до	adp.
virä	распространятся	v.
vrrtep	демон	n.
vul	ветка, ветвь	n.
way	песня (древняя или церемониальная)	n.
waytelem	музыкальный аккорд	n.
win	быстрый	adj.
wìntxu	показывать (чтолибо)	vtr.
'ewll	растение	n.
wrrpa	внешний, наружный	n., adv.
wutso	прием пищи, еда	n.
ya	воздух	n.
yawne	любимый, возлюбленный	adj.
ye'rìn	скоро, вскоре	adv.
yerik	йерик (шестиногий олень), шестиног	n.
yey	прямой	adj.
yìm	вязать, связывать, завязывать	vtr.
yol	долгий, длительный, продолжительный по времени	adj.
yom	есть, поглощать, поедать	vtr.
yomhì'ang	дактерон (небольшой насекомоядный зверек)	n.
yomioang	плотоядное растениесосуд	n.
yomtìng	кормить (с объектом в дативе)	vin.
yur	мыть, стирать	vtr.
za'ärìp	тянуть	vtr.
za'u	идти, приходить	vin.
zamunge	приносить	vtr.
zawng	пронзительно кричать, вскрикивать	vin.
zekwä	палец	n.
zene	модальный глалог долженствования	vim.
zìsìt	год	n.
zong	сберегать, экономить	vtr.
zongtseng	безопасное место, убежище	n.
zoplo	оскорбление, обида	n.
zusawkrr	будущее, в будущем	n.
Jakesully	болван, «оседлавший торука»	n.
'ärìp	двигать чтолибо	vtr.
'awstengyem	соединять чтолибо с чемлибо	vtr.
'efu	ощущать, чувствовать, воспринимать	vtr.
'em	готовить еду	vtr.
'eyng	отвечать, отзываться	v.
'i'a	заканчивать, завершать	vin.
'ia	входить в измененное состояние сознания	vin.
fkxake	зудеть, чесаться	v.
fmal	поддерживать, сохранять в прежнем состоянии	vtr.
frìp	кусать	vtr.
ftem	оставлять без внимания, пропускать	vtr.
fwew	искать, пытаться найти	vtr.
hangham	смеяться	vin.
vaykrr	до (какоголибо времени)	conj.
sngap	жалить	vtr.
hawl	готовить, подготавливать	vtr.
kä'ärìp	толкать	vtr.
kavuk si	предавать	vin.
kllkä	спускаться	vin.
latsi	идти вместе с кемлибо, не отставать	v.
lek	принимать чтолибо во внимание, подчиняться чемулибо	vtr.
len	происходить, случаться, иметь место	vin.
lew si	покрывать	vin.
muntxa si	образовывать с кемлибо брачную связь	vin.
näk	пить	vtr.
nong	следовать за чемлибо, происходить вслед за чемлибо	vtr.
oeyktìng	разъяснять (почему)	vtr.
pate	приходить, добираться до места	v.
piak si	открывать	vin.
pom	целовать	vtr.
pxor	взрываться	vin.
salew	проходить, уходить	v.
sar	использовать, применять, употреблять	vtr.
sim	находиться поблизости	svin.
sleyku	изготавливать, производить, выпускать	vtr.
sop	путешествовать	vin.
spä	прыгать	v.
speng	восстанавливать, реставрировать	vtr.
spule	толкать вперёд, двигать, приводить в движение	vtr.
srese'a	пророчествовать, предсказывать	vtr.
steyki	злить, раздражать коголибо	vtr.
sti	быть рассерженным, сердиться (непереходная форма)	vin.
sto	отказываться (делать чтолибо)	vtrm.
sung	добавлять	vtr.
syep	ловить, заманивать в ловушку,	vtr.
tatep	терять	vtr.
tätxaw	возвращаться	vin.
tem	стрелять	vin.
tì'awm si	разбивать лагерь	vin.
tì'awm	разбивка лагеря	n.
tìkangkem si	работать, трудиться	vin.
tìng tseng	отступить, освободить место	vin.
tìsraw seyki	причинять боль комулибо, ранить коголибо	vtr.
tìsraw	боль	n.
tìsraw si	причинить боль, быть болезненным	vin.
toltem	стрелять (переходная форма)	vtr.
tsä'	брызгать	v.
tsaheyl si	устанавливать связь посредством нейронных волокон	vin.
tsap'alute si	извиняться	vin.
tsawl slu	расти	vin.
tsngawvìk	плакать, хныкать	vin.
tsre'i	бросать, кидать	vtr.
tstu si	закрывать	vin.
tsunslu	быть возможным	vin.
tsurokx	отдыхать	vin.
tungzup	ронять, бросать	vtr.
wem	драться, воевать	vin.
win säpi	торопиться	vin.
win si	делать чтолибо быстро, второпях, наспех	vin.
yän	привязывать, связывать, спутывать, пристегивать	vtr.
yem	положить, поставить	vtr.
zenke	модальный глагол долженствования с отрицанием (не должен)	vim.
zup	падать	vin.
nekll	снизу, внизу, ниже	adv.
srung si	помогать	vin.
txopu si	бояться	vin.
fkip	вверху (вместе с кемлибо или среди коголибо)	adp.
io	над	adp.
kxamlä	сквозь	adp.
lok	рядом (с чемлибо), близко (к чемулибо)	adp.
maw	после	adp.
mìkam	между	adp.
nemfa	внутрь, внутри	adp.
pxaw	вокруг	adp.
pxel	как, подобно	adp.
sìn	на	adp.
takip	от группы коголибо, из нескольких	adp.
uo	позади, сзади	adp.
luke	без	adp.
tafkip	вниз от группы коголибо	adp.
ro	приставка местоположения	adp.
sre	до, раньше	adp.
wä	против	adp.
fäpa	верх, макушка	n.
alìm	далеко, вдалеке	adv.
aylaru	к другим (датив)	pn.
kxu	вред, ущерб	n.
eltu lefngap	компьютер	n.
kì'ong	медленный	adj.
säfpìl	мысль, идея	n.
kefyak	не так ли?	part.
prrwll	мох	n.
pängkxoyu lekoren	юрист	n.
pamrel	написаное, почерк	n.
pamrel si	писать	vin.
furia	что (соединительный союз в сложноподчиненном предложении)	pn., sbd.
fratseng	везде	adv.
fratrr	ежедневно	adv.
frato	служебное слово для образования превосходной степени прилагательного (чем все)	part.
trray	завтра	adv.
kea	не (с существительными)	adj.
ngian	однако	adv.
skepek	официально	adj.
hufwa	хотя, несмотря на то, что	conj.
tup	вместо того, чтобы	conj.
'uo	чтото, нечто	pn.
tuteo	ктото	pn.
tsengo	гдето	pn.
holpxaype	сколько? как много?	inter.
hìm	немногочисленный, небольшой по числу	adj.
hìmtxampe	сколько? (с неисчисляемыми существительными)	inter.
hìmtxan	количество	n.
pìmtxan	сколько? (с неисчисляемыми существительными)	inter.
lì'upe	какое? что за? (вопрос к слову или высказыванию)	inter.
pelì'u	какое? что за? (вопрос к слову или высказыванию)	inter.
ultxarun	случано встретить коголибо	vtr.
ultxa si	встретиться с кемлибо по собственному желанию (используйте hu with)	vin.
rangal	желать	vin.
nìrangal	«как хотелось бы»	adv.
txepvi	искра	n.
nitram	радостный, счастливый	adj.
fewi	преследовать	vtr.
stä'nì	ловить	vtr.
sran	да (разговорная форма)	part., intj.
weyn	рисовать, делать иллюстрации	vtr.
fìtrr	сегодня	adv.
rusey	живой, живущий, живое существо	adj., n.
vitra	душа	n.
nìzawnong	безопасно	adv.
ftawnemkrr	прошлое	n.
txal	спина	n.
tsìng	четыре	num.
mrr	пять	num.
pukap	шесть	num.
kinä	семь	num.
vol	восемь	num.
zam	шестьдесят четыре	num.
tìoeyktìng	объяснение	n.
lesar	полезный	adj.
tse	ну (вводное междометие)	part.
skxom	шанс, возможность	n.
fkxen	овощ	n.
syä'ä	горький	adj.
yemfpay si	окунать, погружать в жидкость	vin.
yemfpay	окунание, погружение в жидкость	n.
keng	даже	adv.
'awlo	однажды, один раз	adv.
melo	дважды, два раза	adv.
heyn	сидеть	vin.
nìpxim	прямо, вертикально	adv.
pxim	прямой, вертикальный	adj.
tuvon	облокачиваться, наваливаться, опираться	v.
nìfya'o	в некотором роде	adv.
letrrtrr	обычный, стандартный, каждодневный	adj.
nì'eoio	торжественно	adv.
'eoio	торжественный	adj.
rìk	листок (растения)	n.
lerìk	густой (о листве)	adj.
pa'o	сторона, половина	n.
kllpa	низ, дно	n.
mìfa	внутри, внутренняя сторона	n., adv.
nefä	вверх	adv.
zapxì	передняя часть, перед	n.
käpxì	задняя часть, зад	n.
käsatseng	там	adv.
ftxey	ли... или нет (использущийся в предложениях вроде «Нравится (ли) это им или нет» парный союз)	conj.
ngaytxoa	простите, извиняюсь	intj.
flew	горло, глотка, гортань	n.
kxa	рот	n.
nikre	волосы	n.
pewn	шея	n.
re'o	голова	n.
sre'	зуб	n.
tsuksìm	подбородок	n.
key	лицо	n.
puk	книга	n.
ngäng	желудок	n.
ta'leng	кожа, шкура	n.
tsyokx	рука (кисть)	n.
reypay	кровь	n.
tsopì	легкое (орган)	n.
venu	нога (ступня)	n.
venzek	палец ноги	n.
ramunong	колодец	n.
payfya	поток	n.
pxawpa	периметр, окружность, граница	n.
txampay	море, океан	n.
'ora	озеро	n.
ekxan	баррикада, преграда	n.
tsim	источник	n.
tsray	деревня	n.
txayo	поле, открытое пространство	n.
ukxo	сухой	adj.
wew	холодный	adj.
fìtxon	сегодня вечером	adv., n.
txonam	прошлой ночью	adv.
txonay	завтра ночью	adv.
sekrr	в данный момент	n.
vur	рассказ, история	n.
tìpängkxo	разговор, обсуждение	n.
tìsrese'a	пророчество	n.
nawmtu	важный человек	n.
txantstew	герой	n.
syuve	еда	n.
tsngan	мясо	n.
tstal	нож	n.
tete	тупой (о лезвии)	adj.
lew	крышка	n.
'opin	цвет	n.
leNa'vi	относящийся к Народу (на'ви)	adj.
nìNa'vi	подобно на'ви, «понавийски»	adv.
hapxìtu	участник, член	n.
'Rrta	Земля	prop.n.
fwäkìwll	богомолова орхидея	n.
hì'ang	насекомое	n.
payoang	рыба	n.
yayo	птица	n.
zize'	огненная оса	n.
kemlì'u	глагол	n.
tstxolì'u	существительное	n.
ftär	левый (о стороне, направлении и т.п.)	adj.
skien	правый (о стороне или направлении)	adj.
'änsyem	законченный, завершенный	adj.
wotx	полнота, цельность	n.
mowan	приятный, приносящий удовольствие	adj.
vä'	неприятный слуху 	adj.
tatlam	очевидно	adv.
keteng	другой, отличный	adj.
numtseng	школа	n.
skxakep	вероятный, вероятно	adj., adv.
tìprrte'	удовольствие	n.
kaw'it	вовсе нет, немного не так (используется с ke; см. ke kaw'it не... вовсе во фразах)	adv.
nìlkeftang	непрерывно, безостановочно, постоянно	adv.
tì'i'avay	до конца	adv.
'awm	лагерь	n.
tìska'a	разрушение, уничтожение	n.
tìsop	путешествие	n.
wempongu	боевой отряд	n.
asim	близко, рядом	adv.
klltseng	положение, позиция	n.
kxutu	враг	n.
mekre	припасы	n.
tìhawl	подготовка, план	n.
tìkan	цель, намерение	n.
tìpähem	прибытие	n.
numeyu	учащийся, обучающийся	n.
soaia	семья	n.
tìmuntxa	замужество, брак	n.
yawnetu	любимый, возлюбленный	n.
yawntu	любимый, возлюбленный	n.
kakrel	слепой	adj.
kanu	умный, сообразительный	adj.
koak	старый, пожилой (употр. с одушевленными предметам)	adj.
lekye'ung	безумный, сумасшедший	adj.
me'em	гармооничный	adj.
txanew	жадный	adj.
txantur	могущественный	adj.
tì'awpo	индивидуализм (негативное значение), эгоизм	n.
tì'eylan	дружба	n.
fkay	ненавистный	adj.
keltsun	невозможный	adj.
kxuke	безвредный	adj.
lehawng	чрезмерный, неумеренный, непомерный	adj.
hawng	чрезмерное изобилие	n.
lekin	необходимо	adj.
stxong	чужой, незнакомый, неизвестный	adj.
syen	последний, окончательный	adj.
kavuk	предательство	n.
fpìlfya	образ мысли, способ мышления	n.
syay	судьба	n.
tìfnu	тишина, молчание	n.
tìngop	создание, творение	n.
tìpe'un	решение	n.
kxitx	смерть	n.
trr'awve	воскресенье	n.
trrmuve	понедельник	n.
trrpxeyve	вторник	n.
trrtsìve	среда	n.
trrmrrve	четверг	n.
trrpuve	пятница	n.
trrkive	суббота	n.
'ango	тихий (о звуке)	adj.
kxayl	высокий	adj.
rey'eng	равновесие жизни	n.
tìme'em	гармония, лад	n.
fnel	род, тип	n.
fnepe	какого типа, вида	inter.
pefnel	какого типа, вида	inter.
zerok	помнить	vtr.
tswa'	забывать	vtr.
tì'efu	ощущение, чувство	n.
maweypey	терпеть, быть терпеливым	svin.
tìmweypey	спокойствие	n.
lemweypey	терпеливый	adj.
nìmweypey	терпеливо	adv.
tsakrrvay	до того, как	adv.
ohakx	голодный	adj.
tìohakx	голод	n.
tsyosyu	приготовленная из муки еда	n.
vey	приготовленная из животного материала еда, мясо	n.
trrpeve	какой день недели	inter.
pxiswawam	только что	adv.
pxiset	в настоящий момент, прямо сейчас	adv.
pxiswaway	через мгновение	adv.
pxiye'rìn	немедленно (но не так скоро, как pxiswaway)	adv.
pxisre	непосредственно перед	adp.
pximaw	непосредственно после	adp.
sok	недавний	adj.
'awlie	однажды	adv.
tìkxey	ошибочность, неправильность	n.
tìkxey si	напутать, наделать ошибок	vin.
tìyawr	верность, правильность	n.
tìketeng	различие, разница	n.
fpomtokx	физическое здоровье	n.
lefpomtokx	здоровый (физически)	adj.
kelfpomtokx	нездоровый (физически)	adj.
keftxo	грустный, печальный, «как жаль!»	adj., intj.
nìkeftxo	грустно, печально	adv.
sraw	болезненный, причиняющий боль	adj.
txampxì	большинство, основная часть	n.
vurvi	краткое изложение, пересказ	n.
sänumvi	урок	n.
letam	достаточный	adj.
letsranten	важный, значимый	adj.
nìswey	оптимально, наилучшим образом	adv.
nìpxi	особенно, явным образом, направленно	adv.
wok	громкий	adj.
spuwin	старый, прежний	adj.
nì'eyng	в ответ на	adv.
nìkanu	разумно, поумному	adv.
nìlaw	явно, определенно, четко	adv.
tìsti	гнев, злоба	n.
tìtxanew	жадность	n.
tìftxey	выбор	n.
tìkanu	ум, разум	n.
tìlam	внешность, внешний вид	n.
tìtslam	понимание, разум	n.
tìtxula	строительство, сооружение	n.
hewne	мягкий (с неодуш. предметами)	adj.
tìm	низкий	adj.
laro	чистый	adj.
tsewtx	грязный	adj.
lefngap	металлический	adj.
txa'	твердый, тяжелый	adj.
fwel	сломанный	adj.
etrìp	предпочитаемый, излюбленный, благоприятный	adj.
piak	открытый	adj.
tstu	закрытый	adj.
kxll si	нападать	vin.
tsaw	это, то (синоним tsa'u)	dem., pn.
tsalsungay	все же, несмотря на, хотя	adv.
oìsss	окрик, призыв к порядку, призыв обратить внимание	intj.
saa	устрашающий выкрик	intj.
sau	кряхтение, сопровождающее напряженное усилие междометие	intj.
tsahey	«проклятье!», «вот досада!», выражающее разочарование или предостережение местоимение	intj.
wiya	«чёрт побери!», выражающее разочарование или предостережение междометие	intj.
ìley	боевой клич	intj.
vawm	темный	adj.
tìvawm	тьма, темнота	n.
polpxay	сколько	inter.
ke'aw	разделенный, разорванный, находящийся в состоянии раздора	adj.
nìsti	гневно	adv.
teyr	белый	adj.
layon	черный	adj.
pänu	обещание	n.
kew	ноль	num.
'eyt	восьмерка, символ 8 (не значение числа 8)	n.
nayn	девятка, символ 9 (не значение 9)	n.
trr'ong	восход	n.
trr'ongmaw	рассвет после восхода солнца	n.
rewon	утро	n.
srekamtrr	перед полуднем	n.
kxamtrr	полдень	n.
kxamtrrmaw	пополудни, время сразу после полудня	n.
ha'ngir	после полудня	n.
kaym	вечер до сумерек, позднее пополудни	n.
sreton'ong	сумерки, вечер до заката	n.
txon'ong	закат, наступление ночи	n.
txon'ongmaw	сумерки после заката до наступления темноты	n.
srekamtxon	до полуночи	n.
kxamtxon	полночь	n.
kxamtxomaw	после полуночи	n.
sresrr'ong	утро перед рассветом	n.
wou	быть удивленным, восхищенным (сленг)	svin.
tsyìräfì	жираф	n.
tsawa	что	pn., sbd.
tsata	что	pn., sbd.
tsaria	что	pn., sbd.
alo	раз, круг (одно из повторений)	n.
fralo	каждый раз	adv.
nìmwey	спокойно	adv.
ku'up	тяжелый (физический вес)	adj.
syo	легкий (физический вес)	adj.
hay	следующий	adj.
ham	предыдущий	adj.
matsa	маца, крекеры	n.
hametsì	дрожжевой хлеб	n.
tìkangkemvi	проект	n.
nì'i'a	финально, в конце	adv.
nìsyen	окончательно	adv.
pìlok	блог	n.
tsulfätu	умелец, эксперт	n.
tsulfä	мастерство	n.
tsulfä si	управлять	vin.
numtsengvi	класс (часть школы)	n.
rofa	в стороне	adp.
pum	тот (заменитель предыдущего существительного или местоимения)	pn.
Yuesey	США	prop.n.
teya si	заполнить (с заполняемым предметом в дативе)	vin.
alunta	поскольку, по причине	conj.
nìprrte'	с удовольствием	adv.
sngä'iyu	начинающий, «чайник»	n.
srekrr	перед, уже	adv.
ayu	вещи	n.
tsafya	так, таким способом	adv.
muve	второй	adj.
pxeyve	третий	adj.
tsìve	четвертый	adj.
mrrve	пятый	adj.
puve	шестой	adj.
kive	седьмой	adj.
volve	восьмой	adj.
tsyänel	телеканал	n.
trrtxon	суточный цикл Пандоры	n.
au	выражение ужаса	intj.
pängkxoyu	собеседник	n.
lekoren	правильный	adj.
prrkxentrrkrr	учебное словоскороговорка	n.
tìftia	учение	n.
tìftia kifkeyä	наука, изучение реального мира	n.
pxir	пиво	n.
eanean	чидл, травянистое растение	n.
'ele'wll	кактус	n.
tstxa'a	canalyd	n.
pa'liwll	кувшин для пандорианской лошади (растение)	n.
anìheyu	голубое спиральное растение	n.
tompawll	дождевое растение	n.
pxiwll	пустынное растение	n.
syeptute	hyneman, растениеловушка	n.
kllpxiwll	lionberry	n.
smaoe	phalanxia, колючее растение	n.
'ä'o	кувшинообразное растение	n.
mulpxar	петушиноголовое растение	n.
flefle	Sol's delight, магнитотрофическое растение	n.
kxaylte	cillaphant	n.
fkxakewll	зудящее растение	n.
tìhawnuwll	защитное растение	n.
pxorna'lor	sari, красивое растение со взрывающимися семенами	n.
pxayzekwä	sari,	n.
mìnyu	скрученная лилия	n.
mìnyu	скрученная лилия	n.
väfewll	дурно пахнущее растение	n.
sngukx	растениеличинка	n.
rawp	полип	n.
'ampirikx	кувшинолистное растение	n.
apxangrr	delta tree	n.
värumut	vein pod	n.
keyawr	неправильное	adj.
lehrrap	опасный	adj.
tìtxen	бодрствование	n.
hìrumwll	puffer plant	n.
fwäkì	богомол	n.
fratxon	каждая ночь	adv.
hìkrr	секунда, очень короткое время	n.
mawkrr	впоследствии	adv.
ngeyn	усталый	adj.
ngopyu	создатель	n.
nìk'ong	медленно	adv.
pamtseotu	музыкант	n.
sat	это	pn.
tsal	это (агенс)	pn.
tsat	это (пациенс)	pn.
tsawlhì'	размер	n.
lì'fyavi	выражение, элемент языка	n.
nafì'u	такой	adj.
lì'fyaolo'	языковая группа	n.
puktsyìp	буклет	n.
utraltsyìp	куст	n.
säspxintsyìp	незначительное недомогание	n.
'itetsyìp	доченька (нежно)	n.
sa'nutsyìp	юная мама (для молодых девушек)	n.
kem si	делать	vin.
tswin	коса	n.
tswintsyìp	косичка	n.
taronyutsyìp	молодой охотник	n.
oetsyìp	маленький я 	pn.
ngatsyìp	маленький ты	pn.
atanvi	луч	n.
txeptsyìp	огонек	n.
tìkusar	учение (процесс)	n.
tìyusom	поедание	n.
tìtusaron	охота (как процесс)	n.
tìpängkxotsyìp	небольшой разговор	n.
hayalo	следующий раз	adv.
hamalo	последний раз	adv.
tstunwi	добрый, тактичный	adj.
seykxel	сильный (эмоционально, духовно), надежный	adj.
fuke	или нет	conj.
'a'aw	несколько	adj.
'okrol	история (древняя)	n.
'okvur	история (не древняя)	n.
alu	другими словами	conj.
fnawe'	трусливо	adj.
fnawe'tu	трус	n.
ftxìlor	вкусный	adj.
ftxìvä'	невкусный	adj.
fyeyn	зрелый, взрослый	adj.
fyeyntu	взрослый (о человеке)	n.
tìfyeyn	взрослость, зрелость	n.
hawngkrr	поздно	adv.
lehawngkrr	поздний	adj.
leye'krr	ранний	adj.
hek	чудить, юродствовать	vin.
nìhek	странно	adv.
ki	но взамен	conj.
nìfyeyntu	повзрослому, зрело	adv.
nì'eveng	подетски, ребячески	adv.
lìng	парить (в воздухе)	vin.
ram	гора	n.
muntxatu	супруг	n.
muntxatan	муж	n.
muntxate	жена	n.
netrìp	счастливо, удачно	adv.
newomum	любопытствовать, желать понять	svin.
lenomum	любопытный	adj.
tìnomum	любопытство	n.
ngäzìk	трудный	adj.
tìngäzìk	трудность, проблема	n.
nìsung	коме того, тем не менее	adv.
reng	мелко (физически)	adj.
rolun	Эврика!	intj.
sa'sem	родители	n.
smar	жертва, объект охоты	n.
starsìm	собирать (урожай, дикорастущие растения)	vtr.
sunu	быть приятным, желательным, радующим	vin.
syayvi	шанс, удача	n.
nìsyayvi	удачно	adv.
tolel	Эврика!	intj.
txukx	глубоко (пространственно)	adj.
ve'kì	ненавидеть	vtr.
tìve'kì	ненависть	n.
yaymak	глупый, необразованный	adj.
ye'krr	рано	adv.
zìsìkrr	время года	n.
zo	быть в хорошем состоянии, быть «как следует» или в соответствии с природой	svin.
zoslu	выздоравливать	vin.
zeyko	излечивать	vtr.
frawzo	здорово!	intj.
kemlì'uvi	инфикс	n.
irayo si	благодарю	vin.
lefkrr	современный	adj.
lì'upam	акцент, произношение	n.
natkenong	например	conj.
eltur tìtxen si	быть интересным, интригующим	vin.
pxelo	трижды	adv.
pamrelfya	правописание	n.
law si	объяснять	vin.
tìsung	добавление, постскриптум (P.S.)	n.
naer	питье	n.
atxkxerel	карта	n.
nìtengfya	так же как (о действии)	adv.
tun	красный, оранжевый	adj.
'om	фиолетовый, пурпурный	adj.
neyn	яркие краски, оттенки светлого	adj.
ngul	серый, тусклый	adj.
tumpin	красный, оранжевый	n.
eampin	голубой, зеленый	n.
rimpin	желтый	n.
'ompin	фиолетовый, пурпурный	n.
layompin	черный	n.
teyrpin	белый	n.
vawmpin	темный	n.
neympin	светлый	n.
ngulpin	серый	n.
pil	полоска на коже лица	n.
ta'lengean	голубой как кожа	adj.
rìkean	зеленый как лист	adj.
kllvawm	коричневый	adj.
'evan	мальчик (разг.)	n.
'eve	девочка (разг.)	n.
'evengan	мальчик	n.
'evenge	девочка	n.
fkio	tetrapteron	n.
kenten	веерная ящерица	n.
nìwä	напротив	adv.
pìwopx	облако	n.
ramtsyìp	холм	n.
syaksyuk	prolemuris	n.
tor	последний	adj.
txärem	кость	n.
uk	тень	n.
yapay	туман, пар	n.
tìspe'e	добыча	n.
tìftxavang	страсть	n.
tìtstunwi	доброта	n.
stxeli	подарок	n.
ngrrpongu	низовое движение	n.
smon	быть известным	vin.
lawk	дискутировать, высказаться о..	vtr.
hìtxoa	извините	intj.
mäkxu	нарушение гармонии	vtr.
hultstxem	мешать	vtr.
mok	предлагать	vtr.
muwìntxu	представлять	vtr.
kan'ìn	интересоваться, специализироваться	vtr.
tìwusem	борьба (абстрактно)	n.
nì'eng	эквиваллентно	adv.
Pari	Париж	prop.n.
tì'ong	цветение	n.
tìmok	предложение (абстрактная идея)	n.
tì'em	поварское искусство	n.
leyn	повторять	vtr.
päsketpol	баскетбол	n.
nìFranse	пофранцузски	adv.
nìToitsye	понемецки	adv.
nìno	подробно	adv.
hìno	точный, углубленный,сложный (о вещи)	adj.
leno	вдумчивый	adj.
tìno	вдумчивость, внимание к деталям	n.
'ongokx	родиться	vin.
nokx	породить	vtr.
nìtrrtrr	ежедневно	adv.
tìn	занятие	n.
txin	главный, первичный	adj.
txintìn	деятельность, основная роль в обществе	n.
'emyu	повар	n.
vewng	смотреть на, отвечать за	vtr.
kaltxì si	поприветствовать	vin.
sopyu	путешественник	n.
fula	что	pn., sbd.
tskxekeng si	упражняться, тренироваться	vin.
way si	петь 	vin.
swawtsyìp	мгновение, секунда	n.
käteng	тратить время на	vin.
'ìn	иметь занятие	svin.
Sweriye	Швеция	prop.n.
nìfkrr	позднее, сейчас	adv.
sulìn	быть занятым (в позитивном смысле), быть поглощенным чемто увлекательным	svin.
vrrìn	быть занятым (в отрицательном смысле), быть утомленным и задавленным неким делом	svin.
tìk'ìn	свободное время	n.
säsulìn	хобби, приятная занятость	n.
'o'	радующий, восхищающий	adj.
Europa	Европа	prop.n.
skxaypxe	Skype	n.
pxorpam	эжективная согласная	n.
tì'o'	веселье	n.
nì'o'	весело	adv.
fnan	пригодность для	vtr.
wätx	непригодность для	vtr.
tìsom	теплота, жара	n.
tìwew	холод	n.
tìlen	случай	n.
nìnäk	через жидкость	adv.
nìhay	?после?	adv.
sayrìp	статный, хорошо выглядящий	adj.
letokx	телесный	adj.
säzärìp	узда	n.
ìpxa	папортник	n.
tìhawnu si	защитить	vin.
sno	его, её (генитив  sneyä)	pn.
kìte'e si	служить	vin.
var	продолжать действие	vim.
nìftxan	так, до этих пределов	adv.
Yeysu	Исус	prop.n.
lelì'fya	языковый	adj.
takrra	с (время)	conj.
akrrta	с (время)	conj.
few	через (на противоположную сторону)	adp.
fewtusok	противоположный (сторона)	adj.
sla'tsu	описывать	vtr.
tìsla'tsu	описание	n.
'en	догадка?, интуиция	n.
'en si	догадаться	vin.
le'en	предположительный, интуитивный	adj.
nì'en	интуитивно	adv.
sä'o	инструмент	n.
pamtseo si	играть музыку (с fa для указания инструмента)	vin.
väng	жаждущий	adj.
tìväng	жажда	n.
sngum	беспокойство	n.
nìsngum	беспокойно	adv.
yayayr	смущение	n.
wäte	спорить	vtr.
tìwäte	спор, аргумент	n.
säwäte	предмет спора	n.
lewäte	непримиримый, склочный	adj.
nìwäte	склочно	adv.
li	уже	adv.
lisre	до того (о времени)	adp.
ronsrelngop	вообразить, предвидеть (с.с. от ronsem разум, rel картинка, ngop создать, разговорное произношение [Ron.sREw.Nop])	vtr.
ronsrel	воображаемое	n.
tìronsrel	воображение	n.
txanatan	яркий	adj.
leronsrel	воображаемый	adj.
nìronsrel	в воображении	adv.
srefey	ожидать	vtr., vin.
mawl	половина	n.
pan	треть	n.
wan	скрыть	vtr.
nìwan	секретно, скрытно	adv.
tìwan	сокрытие	n.
letwan	изворотливый, скользкий (тдл.)	adj.
slele	плавать	vin.
nìslele	плавая	adv.
tìtaron	охота (абстрактная деятельность)	n.
ìì	хмм, эээ	intj.
tsukyom	съедобное	adj.
ketsuktswa'	незабываемый	adj.
tsuktswa'	забываемый	adj.
yafkeyk	погода	n.
fkeytok	существовать	vin.
tìfkeytok	состояние, ситуация	n.
tompameyp	мелкий дождь	n.
tskxaytsyìp	град	n.
tskxepay	снег	n.
herwì	снег	n.
tomperwì	дождь со снегом	n.
txanfwerwì	метель	n.
hermeyp	снежный шквал	n.
hertxayo	снежное поле	n.
ìlva	чешуйка, капля, цепка	n.
txepìva	зола	n.
herwìva	снежинки	n.
payìva	капля воды	n.
tompìva	дождевая капля	n.
kintrr	неделя	n.
mrrtrr	рабочая неделя, пятидневка	n.
muntrr	выходные дни	n.
kintrram	последняя неделя	n.
kintrray	следующая неделя	n.
muntrram	последние выходные	n.
muntrray	следующие выходные	n.
vospxì	месяц	n.
vospxìam	последний месяц	n.
vospxìay	следующий месяц	n.
sweylu	следует	v.
ye	подходящий	adj.
hasey si	закончить, привести к завершению	vin.
seysonìltsan	отлично! (от hasey soli nìltsan хорошо завершено)	intj.
yehakx	насытившийся	adj.
yeväng	напившийся	adj.
somwew	температура	n.
pup	короткий (физическая длинна)	adj.
ngimpup	длинна	n.
pesomwew	какая температура?	inter.
somwewpe	какая температура? (более общее)	inter.
txawew	очень холодно	adj.
wur	холодный	adj.
tsyafe	мягкий, умеренный, комфортный	adj.
sang	теплый	adj.
txasom	очень горячий	adj.
leyapay	туманный	adj.
lepwopx	облачно	adj.
nìhol	несколько, немного	adv.
nìpxay	много, во многом	adv.
paynga'	влажный	adj.
meuianga'	почтенно	adj.
txumnga'	ядовито	adj.
'akra	почва (плодородная)	n.
hufwetsyìp	ветерок	n.
nìlam	частично	adv.
nìli	заранее	adv.
nìfrakrr	обычно	adv.
am'a	сомнения	n.
nga'	содержать	vtr.
tìftang si	остановить	vin.
may'	попытаться, проверить, оценить, испытать	vtrm.
yora'	победить	vtr.
snaytx	потерять	vtr.
tìyora'	победа 	n.
tìsnaytx	потеря	n.
'otxang	музыкальный инструмент	n.
skxir	рана	n.
leskxir	раненый	adj.
skxir si	ранить	vin.
skxirtsyìp	ранка, царапина	n.
sloan	лить	vtr.
emrey	прежить, выжить	vin.
temrey	выживание	n.
lemrey	выживший	adj.
nemrey	как будто жизнь была поставлена на карту	adv.,intj.
wawe	значительность, важность	n.
txanwawe	знаменательный	adj.
nìwawe	значительно	adv.
keyrel	выражение лица	n.
fwampop	тапир	n.
säplltxe	утверждение	n.
säplltxevi	комментарий	n.
kawtseng	нигде	adv.
tsapo	тот	pn.
fwefwi	свист	vin.
'etnaw	плечо	n.
pllngay	признать	vin.
kawngsar	использовать	vtr.
lom	отсутствующий	adj.
koaktan	старик	n.
koakte	старуха	n.
koaktu	старый человек	n.
lomtu	отсутствующий	n.
fe'	плохой	adj.
nìfe'	плохо	adv.
wätu	оппонент	n.
fekem	катастрофа, несчастье	n.
hawtsyìp	короткий дневной сон	n.
uran	лодка	n.
ftxozä si	праздновать	vin.
kekem	безделие	pn., adv.
pxen	рабочая одежда	n.
tewng	набедренная повязка	n.
raspu'	краги (защитные накладки на руки и ноги для войны или стрельбы из лука)	n.
hawnven	обувь	n.
hawntsyokx	перчатки	n.
hawre'	головной убор	n.
ioi	украшение, церемониальная одежда	n.
nìlun	банально, логично, исходя из здравого смысла	adv.
'ali'ä	воротник, ожерелье, галстук	n.
'are	плащ, накидка, шаль	n.
fkxile	нагрудное ожерелье	n.
masat	нагрудник (вооружение)	n.
nikroi	украшение для волос	n.
pxawpxun	нарукавная повязка	n.
renten	защитные очки (сделанные из крыльев насекомых и т.п.)	n.
tsamopin	боевая раскраска	n.
tsang	пирсинг	n.
miktsang	серьга	n.
ontsang	носовое кольцо	n.
yemstokx	надевать	vtr.
ioi si	украшать	vin.
'aku	убрать, унести	vtr.
le'aw	единственный, исключительный	adj.
mawkrra	после (время)	conj.
akrrmaw	после (время)	conj.
Toitslan	Германия	prop.n.
Toitsye	немецкий (язык)	adj.
lukpen	голый, неодетый	adj.
fmawnta	эти новости	n.
vin	запросить	vtr.
mìftxele	в этом отношении, относительно этого	adv.
zìma'uyu	новичок, только что прибывший	n.
nìvingkap	кстати	adv.
txankrr	надолго	adv.
vingkap	обратить внимание	vtr.
tìomum	знание	n.
tinan	чтение	n.
ninan	читая	adv.
tsmìm	след (человека или животного)	n.
inan	читать (напр, лес), получить информацию через ощущения 	vtr.
'ä'	оп!	intj.
teynga	этот ответ	n.
teyngla	этот ответ (эргатив)	n.
teyngta	этот ответ (винительный)	n.
fayluta	эти слова	n.
stxenu	предложение	n.
tìtstew	храбрость, смелость	n.
tìtstewnga'	храбрый, смелый	adj.
stxenutìng	предлагать	vtr.
tsyär	освободить	vtr.
tìtsyär	освобождение	n.
mll'an	принять	vtr.
tìmll'an	приятие	n.
kam	назад (о времени)	adp.
kay	через (о времени)	adp.
'awnìm	избежать	vtr.
steng	похожий	adj.
nìsteng	похоже	adv.
nim	пугливый	adj.
srätx	досаждать, беспокоить	vtr.
säsrätx	досада	n.
rì'ìr	отражение	n.
rì'ìr si	отражать, имитировать	vin.
tsìsyì	шептать	vin.
nìwok	громко	adv.
sätsìsyì	шепот	n.
nìtsìsyì	шепотом	adv.
nìfwefwi	свистяще	adv.
lawr	мелодия	n.
tìng lawr	напеть, петь без слов	vin.
säomum	информация	n.
kosman	впечатляющий	adj.
nìksman	впечатляюще	adv.
letsim	исходный	adj.
lesngä'i	первоначальный	adj.
nìtsim	исходно	adv.
nìsngä'i	первоначально	adv.
ngong	бессильный, ленивый	adj.
walak	активный	adj.
tìngong	бессилие	n.
txi	спешка	n.
letxi	поспешный	adj.
nìtxi	поспешно	adv.
letxiluke	неспешный	adj.
nìtxiluke	неспешно	adv.
kulat	обнаруживать, раскрывать (метафорически)	vtr.
txantompa	ливень	n.
meyam	обнимать	vtr.
sämyam	объятия	n.
fìtsap	друг друга	adv.
nuä	запределами	adp.
kanfpìl	концентрироваться на	vin.
fmokx	ревность, зависть	n.
nìfmokx	ревниво, завистливо	adv.
kìmar	в сезон (растений или животных)	adj.
nìkmar	в правильный сезон, своевременно	adv.
nìngong	лениво, бессильно	adv.
säpom	поцелуй	n.
kxukx	глотать	vtr.
txewm	ужасный	adj.
hìmpxì	меньшинство	n.
kawnglan	злобный	adj.
nutx	густой, толстый	adj.
flì	тонкий	adj.
flìnutx	толщина	n.
sneyä	его, её	pn.
säsyep	ловушка	n.
yora'tu	победитель	n.
snaytu	неудачник	n.
way a plltxe	мелодичный речитатив	ph.
way a rol	песенная поэма	ph.
wayä aylì'u	слова поэмы или текст песни	ph.
ultxatu	участник встречи	n.
wo	достигнуть	vtr.
yawo	взлететь	vin.
tsìk	неожиданно	adv.
kllwo	снижение	vin.
kllpä	приземлиться	vin.
sätswayon	полет	n.
rawn	заменить	vtr.
tìrawn	замещение	n.
särawn	замена	n.
kxeltek	подцепить, поднять	vtr.
fngo'	нуждаться в, требовать	vtr.
säfngo'	требование, потребность	n.
ngam	эхо	n.
slär	пещера	n.
ngampam	стих	n.
ngampam si	слагать стихи	vin.
faoi	гладкий	adj.
ekxtxu	грубый	adj.
yo'	быть совершенным, безуперчным	svin.
nìyo'	совершенно, безгрешно	adv.
nìyol	кратко (по времени)	adv.
tìyo'	совершенство	n.
'ipu	юморной	adj.
tì'ipu	юмор	n.
tìfmi	попытка	n.
sä'ipu	смешной	n.
hangvur	анекдот	n.
lì'uvan	каламбур, игра слов	n.
kanom	приобрести	vtr.
säkanom	приобретение	n.
srìn	передача	vtr.
käsrìn	давать на время	vtr.
zasrìn	занять	vtr.
säsrìn	занятое	n.
pxìmun'i	делить	vtr.
lätxayn	победить в бою, завоевать	vtr.
sälätxayn	победа	n.
yll	общинный	adj.
nìyll	общинно	adv.
hona	милый, обожаемый, привлекательный	adj.
tìhona	привлекательность	n.
fäkä	поднимать	vin.
fäza'u	подняться	vin.
kllza'u	спуститься	vin.
sämok	предложение	n.
mal	надежный, вызывающий доверие	adj.
nìmal	доверчиво	adv.
tìmal	доверие	n.
kllyem	хоронить, закапывать	vtr.
nìtsyìl	поднимаясь	adv.
sätsyìl	подъем (процесс)	n.
rìn	дерево	n.
flawkx	кожа	n.
'ana	лиана	n.
tsngawpay	слезы	n.
tsngawpayvi	слезинка	n.
nìhona	мило	adv.
lepay	водянистый	adj.
'ul	увеличить	vin.
nän	уменьшить	vin.
nìnän	меньше	adv.
nì'ul'ul	увеличивая	adv.
nìnänän	уменьшая	adv.
mek	пустой, незначимый	adj.
leioae	уважение	n.
leioae si	уважать	vin.
säwìntxu	показ	n.
tì'i'a	окончание	n.
srer	показать (в реальности)	vin.
'ìp	убрать из виду	vin.
tsong	долина	n.
tsongtsyìp	яма	n.
ro'a	быть почтенным	vin.
säro'a	подвиг, большое дело	n.
säro'a si	совершить великое дело	vin.
txanro'a	быть известным	vin.
velek	сдаться, потерпеть поражение	vin.
spono	остров	n.
txew	край	n.
txewnga'	ограниченый	adj.
litx	острый (как лезвие)	adj.
fwem	глупый	adj.
syura	энергия	n.
syuratan	биолюминесценция	n.
txonkrr	ночью	adv.
yuey	красивый (внутренняя красота)	adj.
kxem	стоять вертикально	vin.
txay	лежать горизонтально	vin.
nìkxem	вертикальный	adv.
nìtxay	горизонтально	adv.
klltxay	лежать на земле	vin.
klltxeykay	положить (чтото) на землю	vtr.
yo	поверхность	n.
kxemyo	стена, вертикальная поверхность	n.
fyep	держать в руках	vtr.
nìk'ärìp	устойчивый	adv.
nìklonu	твердо, устойчиво, надежно	adv.
nìktungzup	внимательно, надежно	adv.
nìsyep	плотно, железной хваткой	adv.
nìmeyp	свободно	adv.
säfyep	ручка	n.
slan	поддержать (эмоционально, социально или персонально)	vtr.
tìslan	поддержка (эмоциональная, социальная или персональная)	n.
tìeyktan	лидерство	n.
'llngo	бедро	n.
zare'	лоб, бровь	n.
flawm	щека	n.
prrku	матка	n.
ngep	пупок	n.
tawsyuratan	заря	n.
syeha	дыхание	n.
syeha si	дышать	vin.
sko	как, в роли	adp.
sna'o	группа, множество, комплект	n.
snatxärem	скелет	n.
snafpìlfya	философия	n.
snatanhì	созвездие	n.
sästarsìm	коллекция (намеренно собранная кемто)	n.
tsu'o	способность	n.
krra	когда 	conj.
snatanhìtsyìp	звездное скопление	n.
pìwopxtsyìp	туман	n.
tìterkup	смерть (абстрактно)	n.
maweypeyyu	терпящий	n.
ftxulì'u	произносить речь	vin.
ftxulì'uyu	оратор	n.
säftxulì'u	речь, доклад	n.
tìftxulì'u	ораторствование	n.
slantire	вдохновление	n.
slantire si	вдохновлять	vin.
kum	результат	n.
kuma	что (как результат)	conj.
akum	что (как результат)	conj.
fyel	изолировать, сделать непроницаемым	vtr.
zey	особый	adj.
vll	указывать	vin., vtr.
eykyu	лидер (обычно временной или малой группы вроде охотничьей)	n.
am'ake	несомненный	adj.
nam'ake	несомненно	adv.
kezemplltxe	конечно, так сказать	adv.
tare	связывать с	vtr.
nìsoaia	посемейному, вместе (как члены семьи)	adv.
nìolo'	вместе (как члены клана)	adv.
sätare	соединение	n.
sloa	широкий	adj.
snep	узкий	adj.
slosnep	ширина	n.
peslosnep	как широко	inter.
slosneppe	как широко	inter.
hoet	просторный, широкий, экспансивный	adj.
nìhoet	широко, распространенно	adv.
so'ha	быть в энтузиазме от, быть в восхищении от, быть в восторге от	vtr.
tìso'ha	энтузиазм	n.
nìso'ha	с энтузиазмом	adv.
leso'ha	восхищенный	adj.
tsawlultxa	конференция	n.
zìsìtay	следующий год	n.
tìtsunslu	возможность	n.
numultxa	класс (группа учащихся)	n.
numultxatu	член класса	n.
snanumultxa	курс (совокупность классов)	n.
tìflä	успешность	n.
säflä	успех	n.
mesrram	позапозавчера	n., adv.
mesrray	послепослезавтра	n., adv.
pxesrram	три дня назад	n., adv.
pxesrray	через три дня	n., adv.
mong	зависеть от 	vtr.
sru'	давить, подавлять	vtr.
'ekxin	тугой	adj.
um	свободный	adj.
'ekxinum	степень свободы или стянутости	n.
pekxinum	насколько тугой или свободный	inter.
zeswa	трава	n.
zeswavi	стебель травы	n.
lezeswa	травяной	adj.
lopx	паниковать	vin.
hifwo	убегать	vin.
yrrap	шторм	n.
'rrpxom	гром	n.
rawm	молния	n.
rawmpxom	гром и молния	n.
se'ayl	тонкий водопад 	n.
kxor	стена мощных водопадов 	n.
syanan	последовательность водопадов одного потока, последовательность прудов	n.
rurur	вспененая вода	n.
tseltsul	стремнина	n.
tìmeyp	слабость	n.
am'aluke	несомненно	adv.
atanzaw	зигзагообразная молния	n.
nìsìlpey	счастливо	adv.
talun	изза	adp.
nìTsyungwen	Zhongwen	adv.
reykol	играть музыку, петь (поэтично)	vtr.
nrra	гордость, ощущение гордости	n.
lenrra	гордый	adj.
nìnrra	гордо	adv.
snonrra	надменность (отрицательное отношение)	n.
lesnonrra	надменный	adj.
nrr	блестеть	vin.
ylltxep	общественный огонь	n.
txeptseng	место горения огня	n.
ralnga'	поучительный	adj.
munsna	пара	n.
fyin	простой	adj.
ep'ang	сложный	adj.
epxang	каменная банка для маленьких ядовитых паукообразных	n.
fyinep'ang	уровень сложность	n.
pefyinep'ang	как сложно?	inter.
fyinep'angpe	как сложно?	inter.
sngä'itseng	исходное положение	n.
srungsiyu	помощник	n.
srungtsyìp	подсказка	n.
spulmokri	телефон	n.
syeprel	фотокамера	n.
swoa	опьяняющие напитки, «спиртное»	n.
rou	напиться	vin.
pamrelvi	буква (фонетический символ)	n.
snapamrelvi	алфавит	n.
tìtxen si	проснуться	vin.
fnetxum	аллерген	n.
zet	относиться, показывать отношение к	vtr.
ha'	подходить, соответствовать, дополнять	vin.
syon	способность, характеристика	n.
ran	внутренняя сущность	n.
fyole	возвышенный, за пределами совершенства	adj.
loran	изящество	n.
fe'ran	порочность	n.
reyfya	стиль жизни, культура	n.
fe'ranvi	порок	n.
nìran	в сущности	adv.
mo	пространство	n.
snomo	личное пространство	n.
wum	примерно	adv.
kesran	так себе, посредственность	adj.
nìksran	посредственно	adv.
yewla	разочарование, уныние	n.
leyewla	разочарованный	adj.
nìyewla	разочарованно	adv.
yawnyewla	разочарование в любви	n.
ve'o	порядок	n.
vezo	быть в порядке	vin.
vezeyko	организовать	vtr.
vefya	система, процесс, метод, подход	n.
velke	беспорядочно	adj.
venga'	организованный, "во главе угла"	adj.
nìfnu	тихо	adv.
sätaron	охота (мероприятие)	n.
wäsul	состязаться	vin.
tìwäsul	состязательность	n.
säwäsul	соревнование	n.
säwäsultsyìp	раунд соревнования	n.
tìmwiä	справедливость	n.
snew	сжимать	vtr.
txantxew	максимум	n.
snewsye	потусторонний	adj.
hìmtxew	минимум	n.
txantxewvay	максимально	adv.
hìmtxewvay	минимально	adv.
hefi	нюхать (не намеренно)	vtr.
ewku	пробовать на вкус (не намеренно)	vtr.
zìm	осязать (на намеренно)	vtr.
yune	слушать (намеренно)	vtr.
syam	нюхать (намеренно)	vtr.
'ur	внешний вид	n.
sur	вкус, аромат	n.
zir	текстура	n.
tse'atswo	зрячесть	n.
stawmtswo	слушание	n.
hefitswo	обояние	n.
ewktswo	вкус (чувство)	n.
zìmtswo	осязание	n.
fkan	прийти в чувство	vin.
onlor	ароматный	adj.
onvä'	зловонный	adj.
we'ay	кислый	adj.
wip	соленый	adj.
fwang	пряный	adj.
nget	гнилой (но не трупный запах)	adj.
kxänäng	трупный (запах)	adj.
sosul	запах водопада, влажных растений	adj.
unyor	сладко ароматный (для цветов или ароматного дерева или некоторых кухонных специй)	adj.
atxar	пахнущий живым животным (какой бывает вокруг водопоя)	adj.
inanfya	чувство (ощущение)	n.
uvan letokx	физкультура	n.
ftärpa	левая сторона	n.
skiempa	правая сторона	n.
rengop	проектировать (детально)	vtr.
tìrengop	проектирование	n.
särengop	проект	n.
ingyen	чувство непонятного	n.
sngumtsim	источник беспокойства	n.
yayayrtsim	источник замешательства	n.
ingyentsim	тайна, загадка	n.
ingyentsyìp	трюк, фокус, особый приём	n.
ningyen	загадочно	adv.
ingyenga'	загадочный	adj.
sngunga'	беспокоящий	adj.
yayayrnga'	смущенный	adj.
yrr	нетронутый, натуральный	adj.
nìyrr	натурально	adv.
zäfi	модифицированный, не в естественном состоянии	adj.
syor	отдыхать	vin.
tìsyor	отдых	n.
tìfnunga'	тихий	adj.
späpeng	восстановиться 	vin.
'anla	тосковать по	vtr.
sä'anla	тоска	n.
lie	опыт, умение	n.
tsìlpey	надежда (абстрактная идея)	n.
säsìlpey	надежда (на конкретное обстоятельство)	n.
kelsar	бесполезный	adj.
yì	полка, выступ, шаг, ступенька	n.
snayì	лестница	n.
kxaylyì	наивысший уровень	n.
kxamyì	средний уровень	n.
tìmyì	низкий уровень	n.
flrr	заботливый, мягкий (человек или вещь)	adj.
nìflrr	заботливо, мягко	adv.
tìflrr	заботливо, мягко	n.
ngä'än	страдать морально	vin.
kelkin	излишний	adj.
nìkelkin	излишне	adv.
sängä'än	эпизод морального страдания	n.
'eylanay	знакомство (с возможностью подружиться)	n.
eyktanay	представитель, помощник лидера	n.
tsulfätunay	почти мастер	n.
karyunay	помощник учителя	n.
tsan'ul	улучшить	vin.
fe'ul	ухудшить	vin.
tìtsan'ul	улучшение (вообще или абстрактно)	n.
tìfe'ul	ухудшение (вообще или абстрактно)	n.
sätsan'ul	улучшение (конкретное)	n.
säfe'ul	ухудшение (конкретное)	n.
frafya	по любому	adv.
postì	пост (в блоге, на форуме)	n.
ketsran	что бы ни было	adj.,  conj.
kangay si	подтвердить	vin.
txurtel	канат	n.
ropx	отверстие	n.
tsongropx	пещера, углубление	n.
tsrul	гнездо, защищенное место (служащее домом пандорианской фауне)	n.
yayotsrul	птичье гнездо	n.
lini	молодняк	n.
tarnioang	хищник	n.
rong	туннель	n.
swek	прут, брусок, столб	n.
mektseng	щель, пролом	n.
tsenga	где, место где	conj.
fta	узел	n.
fta si	завязать	vin.
fwi	скользить	vin.
oìsss si	шикнуть	vin.
il	изгиб	vin.
kxakx	разбить	vin.
ftumfa	изнутри	adp.
sä'eoio	церемония	n.
sä'eoio si	провести церемонию	vin.
kur	висеть	vin.
nìtkan	целенаправленно	adv.
nìtkanluke	случайно	adv.
nui	потерпеть неудачу	vin.
nìnu	неудачно	adv.
tìnui	неудача (абстрактно)	n.
sänui	неудача (конкретная)	n.
fngä'	отдохнуть, использовать комнату отдыха (на Земле)	vin.
zun	если (в зависимости от фактов)	conj.
zel	то (в зависимости от фактов)	adv.
'ekxinumpe	как туго или свободно?	inter.
okup	молоко	n.
loi	яйцо	n.
tsyeym	драгоценность	n.
wokau	качающийся барабан	n.
srä	тканая одежда 	n.
srok	бусина 	n.
pxayopin	цветастый	adj.
tsyoklìt	шоколад	n.
paynäpll	ананас	n.
pamrelsiyu	писатель	n.
rel arusikx	фильм	n.
lì'upuk	словарь	n.
lì'upuk	словарь	n.
nìkemweypey	нетерпеливо	adv.
kelemweypey	нетерпеливый	adj.
'on	форма	n.
salewfya	направление	n.
koum	скругленный	adj.
ko'on	кольцо, овал, скругленная замкнутая фигура	n.
yo'ko	окружность	n.
renulke	неупорядоченный, случайный	adj.
vawt	плотный, без полостей 	adj.
momek	пористый	adj.
yeyfya	прямая линия	n.
yak	развилка	n.
yak si	разветвляться	vin.
nìyeyfya	прямо, по прямой	adv.
nìftär	налево 	adv.
nìskien	направо	adv.
'oratsyìp	пруд, бассейн 	n.
nìyawr	корректно, правильно	adv.
tìsteftxaw	осмотр, проверка, обследование, экзамен	n.
yoa	в обмен на	adp.
txolar	доллар	n.
ewro	евро	n.
lawnol	большая радость	n.
ley	быть в цене, стоить, цениться	vin.
säfmi	попытка, проба	n.
nìfkeytongay	действительно	adv.
mowar	совет, подсказка	n.
mowar si	советовать	vin.
mowarsiyu	советчик	n.
kakpam	глухой	adj.
tìkakpam	глухота	n.
pxek	толчок, пинок	vtr.
kolan	в смысле, то есть	intj.
hena	нести	vtr.
sähena	сосуд, носитель, емкость	n.
paysena	сосуд	n.
tutsena	носилки	n.
tstalsena	ножны	n.
swizawsena	колчан (для седла икрана)	n.
tìkakrel	слепота	n.
ngoa	грязь	n.
mawfwa	после	conj.
neni	песок	n.
fwep	грязь, пыль (на поеверхности)	n.
fwopx	пыль (в воздухе)	n.
nìyey	прямо, непосредственно	adv.
'al	терять, тратить впустую	vtr.
tì'al	напрасно	n.
le'al	напрасный	adj.
nì'al	напрасно	adv.
srey	весия	n.
lupra	стиль	n.
fyolup	изысканный, особенный	adj.
fe'lup	безвкусный	adj.
snolup	"в своем стиле"	n.
'ongop	проектировать	vtr.
'ongopyu	проектировщик	n.
uniltìrantokxolo'	клан или группа аватаров	n.
krrka	в течение	adp.
tìreyn	поезд, тамвай	n.
LosÄntsyelesì	Лос Анжелес	pn.
tson	обязанность, долг, налагаемое требование	n.
nìtson	трудность (обязательства)	adv.
kxìm	команда, приказ, назначение задания	vtr.
tsonta	к (обязанности) (используется с kxìm)	conj.
tìkxìm	приказание, назначение задачи	n.
tìkxìm si	командовать, начальствовать	vin.
kxìmyu	командир, начальник	n.
saylahe	так далее	adv.
fpomron	здоровье (душевное)	n.
lefpomron	здоровый (душевно)	adj.
kelfpomron	нездоровый (душевно)	adj.
srefpìl	подразумевать	vtr.
srefwa	перед	conj.
ken'aw	не только	adv.
släkop	так же	adv.
sngum si	беспокоиться	vin.
