"Frontside"	"Flipside"	"Category"
Navi	Local	Pos
'ampi	toucher	vtr.
'angtsìk	Marteaureau | Marteaureau Titanothère	n.
'aw	1 (un)	num.
'awkx	falaise	n.
'awpo	un (individu)	pn.
'awsiteng	ensemble	adv.
'awve	premier	adj.
'e'al	pire	adj.
'eko	attaquer | pleuvoir à verse (météo)	vtr.
'ekong	rythme	n.
'engeng	plat | nivelé | lisse | horizontal	adj.
'eveng	enfant	n.
'evi	enfant (affecteux)	n.
'ewan	jeune	adj.
'eylan	ami	n.
'ì'awn	rester	vin.
'ìheyu	spirale	n.
'Ìnglìsì	Anglais (langue)	n.
'it	un peu | une petite quantité	n.
'itan	fils	n.
'ite	fille (enfant du parent)	n.
'ok	souvenir	n.
'ong	fleurir | s'épanouir	v.
'u	chose | fait	n.
'upe	quoi? | quel? | quelle? | quelle chose?	inter.
'upxare	message	n.
a	[sbd.] | que | qui	part.
alaksi	prêt	adj.
lìm	être loin | être éloigné	vin.
apxa	large	adj.
atan	lumière | source de lumière	n.
atokirina'	Graines de l'Arbre Sacré	n.
atxkxe	pays | terres	n.
au	[exclamation de consternation]	n.
aungia	présage | signe	n.
awaiei	banshee du paradis | [Bansheba terrestre]	n.
awnga	nous ([inclusif, incluant toi]) | [forme abrégée de]: ayoeng	pn.
ayfo	ils | elles	pn.
aynga	vous tous | vous	pn.
ayoe	nous (exclusif)	pn.
ayoeng	nous (tous) (inclusif, incluant toi)	pn.
äie	vision (spirituelle)	n.
äo	sous | en-dessous de	adp.
ätxäle	demande | requête	n.
ätxäle si	demander (que [devient] tsnì [pour introduire la proposition relative])	vin.
ean	bleu | vert	adj.
eltu	cerveau	n.
eltu si	écouter ([prêter attention à])	vin.
eltungawng	brainworm	n.
emza'u	passer | réussir (un examen)	vtr.
eo	devant | avant	adp.
eyawr	correct	adj.
eyaye	warbonnet | [Bellicum pennatum]	n.
eyk	mener	vtr.
eyktan	leader (meneur)	n.
fa	avec | au moyen de...	adp.
fahew	senteur	n.
fìfya	de cette manière | de cette façon	adv.
fìkem	ça (pour une action)	pn.
fìpo	celui-là (personne ou chose)	pn.
fìtxan	si | tellement	adv.
fìtseng	ici | (à) cet endroit | (à) ce lieu | on peut également dire: fìtsenge	adv., n.
fìtsenge	ici | (à) cet endroit | (à) ce lieu | [on peut également dire]: fìtseng	adv., n.
fì'u	ça | ceci (pour un objet)	pn.
fkarut	éplucher	v.
fkew	puissant | très grand ([peut être interprété comme 'formidable' ou 'considérable'])	adj.
fko	un (dans le sens 'un truc' indéfini)	pn.
flä	réussir	vin.
fmawn	nouvelle (information) | qqch à rapporter	n.
fmetok	tester	vtr.
fmi	essayer | tenter de	vtrm.
fngap	métal	n.
fngapsutxwll	plante | [Pennanemone ciliare]	n.
fnu	calmer | apaiser	vin.
fo	ils | elles	pn.
fpak	stopper | arrêter une action qui est en train de se produire	vin.
fpe'	donner | envoyer	vtr.
fpeio	challenge | défi (cérémoniel)	n.
fpi+	pour l'amour de au bénéfice de	adp.
fpìl	penser | réfléchir	vtr.
fpom	paix | bien-être | bonheur	n.
fpxafaw	medusa	n.
fpxäkìm	entrer	vin.
fra'u	tout | toute chose	pn.
frakrr	toujours | tout le temps	adv.
frapo	tous | tout le monde	pn.
frrfen	visiter	vtr.
frrtu	visiteur | invité	n.
ftang	stopper | arrêter (de faire quelque chose/une action)	vim.
fte	de sorte que | afin que	conj.
fteke	afin d'éviter que | de crainte que	conj.
ftia	étudier	vtr.
ftxì	langue (l'organe)	n.
ftxozä	célébration | évènement joyeux	n.
ftu	de (direction)	adp.
ftue	facile	adj.
ftxavang	passionné(e)	adj.
ftxey	choisir	vtr.
fu	ou (dans le sens  | ça ou ça)	conj.
futa	généralement traduit par que | répétition du sujet ou infinitif	sbd.
fwa	ce qui...	sbd.
fya'o	voie | chemin	n.
fyape	comment	inter.
fyawìntxu	guider	vin.
ha	ainsi | dans ce cas	adv.
hahaw	dormir	vin.
hapxì	morceau | bout | partie	n.
hasey	fini | terminé	adj.
hawnu	protéger | abriter	vtr.
hì'i	petit (pour une taille)	adj.
hiyìk	rigolo (dans le sens 'étrange' 'louche' 'bizarre')	adj.
hol	(seulement un) peu de | pas beaucoup de	adj.
holpxay	nombre	n.
hrrap	danger	n.
hu	avec	adp.
hufwe	vent	n.
hum	partir | quitter | s'en aller	vin.
i'en	instrument à corde	n.
ikran	banshee (banshee des montagnes)	n.
ikranay	banshee des forêts | ([plus petit cousin du banshee des montagnes])	n.
ioang	bête | animal	n.
irayo	remerciement	n., intj.
ìlä+	suivant | via | par | selon (quelqu'un)	adp.
ka	à travers	adp.
kä	aller	vin.
kali'weya	espèce d'arachnide venimeuse | [Scorpiosista virosae]	n.
kalin	doux	adj.
kaltxì	bonjour | salut	intj.
kämakto	chevaucher	v.
kame	voir  | voir en | ([dans le sens spirituel])	vtr.
kan	viser (à faire qqch/avec une arme) | avoir l'intention de	vtrm.
kangay	valide	adj.
kar	enseigner	vtr.
karyu	professeur | enseignant	n.
kato	rythme	n.
kawkrr	jamais	adv.
kawng	mauvais | pas bon | maléfique	adj.
kawtu	personne	pn.
ke	pas | ne ... pas	part.
ke'u	rien	pn.
kehe	non	part., intj.
kelku	maison	n.
kelku si	habiter | vivre	vin.
kem	action | acte	n.
kempe	quoi | que (action)	inter.
kenong	représenter	vin.
kerusey	mort | décédé	adj.
ketuwong	alien | étranger (la personne)	n.
kewong	étranger (dans le sens 'quelque chose d'étranger')	adj.
keye'ung	démence | folie	n.
kifkey	monde (physique)	n.
kilvan	rivière	n.
kìm	faire: | tourner (qqch) | tournoyer (qqch) | pivoter (qqch)	vtr.
kin	avoir besoin de (qqch)	vtr.
kinam	jambe	n.
kinamtil	genoux	n.
kìng	fil	n.
kip	parmi	adp.
kìte'e	service	n.
kllfro'	être responsable	vin.
kllkulat	arracher | retourner | déterrer	vtr.
kllkxem	être debout | se tenir debout (position)	vin.
kllpxìltu	territoire	n.
kllte	terre | terrain | sol	n.
ko	([solicite un accord])	part.
kop	aussi | également | de plus | ([extension de l'information déjà donnée])	adv.
koren	règle	n.
krr	temps | heure ([au sens temporel])	n.
krrnekx	prendre du temps	vin.
krrpe	quand?	inter.
kunsìp	gunship | hélico de combat	n.
kurakx	chasser | rabattre | (faire) sortir de force	vtr.
kxam	milieu	n.
kxamtseng	centre | place centrale	n.
kxangangang	boum ([onomatopée])	intj.
kxanì	Interdit	adj.
kxawm	peut-être	adv.
kxener	fumée	n.
kxetse	queue	n.
kxeyey	erreur | faute	n.
kxll	charge	n.
lahe	autre	adj.
lam	sembler | apparaître comme	vin.
lapo	l'autre ([personne ou chose])	pn.
latem	changer | [changer qqn/qqch]: leykatem	vin.
law	sûr | certain	adj.
lefpom	joyeux | heureux | paisible	adj.
lertu	collègue	n.
letrr	quotidien | journalier	adj.
letsunslu	possible	adj.
lì'u	mot	n.
lì'fya	langue (qu'on parle)	n.
lok	près de | proche de	vtr.
lonu	relâcher | libérer	vtr.
lor	beau | plaisant aux sens	adj.
loreyu	'helicoradian' | Belle spirale | [helicoradium spirale]	n.
lrrtok	sourire	n.
lrrtok si	sourire	vin.
lu	être | ([utilisé avec un mot au datif pour former le v.] avoir)	vin.
lun	raison	n.
lumpe	pourquoi	inter.
ma	Ô... | Cher/Chère... | [marqueur désignant la personne à qui l'on parle (vocatif)]	part.
makto	monter | chevaucher	vtr.
mawey	calme	adj.
mefo	ils | elles  | ([groupe de deux])	pn.
menari	yeux (deux yeux)	n.
meoauniaea	Harmonie | Vivre en unité avec la Nature	n.
meuia	honneur	n.
meyp	faible	adj.
mi	encore	adv.
mip	nouveau	adj.
mikyun	oreille	n.
mì+	en dedans sur	adp.
mìn	tourner | pivoter	vin.
mìso	loin (position)	adv.
mllte	consentir | approuver | être d'accord	vin.
moe	nous deux (exclusif)	pn.
mokri	voix	n.
muiä	juste | correct	adj.
mun'i	couper	v.
mune	deux	num.
munge	prendre	vtr.
mungwrr	sauf | à part	adp.
muntxa	joint | uni | accouplé	adj.
na	comme | semblable à	adp.
na'rìng	forêt	n.
Na'vi	Le Peuple | Les Na'vis	prop.n.
nang	surprise | exclamation | encouragement	part.
nantang	loup vipère | Caniferratus costatus	n.
nari	oeil	n.
nari si	faire attention | veiller | surveiller	vin.
nawm	grand | noble	adj.
ne	vers (direction)	adp.
ne'ìm	arrière (direction)	adv.
nekx	brûler | consumer	vtr.
neto	loin (direction)	adv.
new	vouloir | désirer	vtrm.
niä	saisir | agripper | s'emparer	vtr.
nì'aw	seulement	adv.
nìawnomum	comme nous savons	adv.
nì'awtu	seul | seule (dans le sens 'être seul(e)')	adv.
nì'awve	premièrement | en premier	adv.
nì'it	peu | un peu | pas beaucoup (pour quelque chose d'abstrait)	adv.
nì'ul	plus	adv.
nìayoeng	comme nous	adv.
nìftue	facilement	adv.
nìftxavang	passionnément (avec tout son coeur)	adv.
nìhawng	trop | excessivement	adv.
nìltsan	bien	adv.
nìmun	encore | de nouveau	adv.
nìn	regarder (quelque chose)	vtr.
nìngay	vraiment | sincèrement	adv.
nìtam	suffisamment	adv.
nìteng	aussi | également | de même | ([en cas d'extension, voir] kop)	adv.
nìtut	continuellement	adv.
nìtxan	beaucoup | plein (pour quelque chose d'abstrait)	adv.
nìwin	rapidement	adv.
nìwotx	tout | complètement | en entier	adv.
nulkrr	longtemps | plus longtemps	adv.
nulnew	préférer	vtrm.
nume	apprendre	vin.
nga	tu | vous ([singulier])	pn.
ngawng	vers	n.
ngay	vrai	adj.
ngenga	tu | vous ([singulier]) | ([honorifique])	pn.
ngim	long | longue	adj.
ngop	créer	vtr.
ngrr	racine	n.
nguway	hurlement | cri de Loup Vipère	n.
oe	je	pn.
oeng	toi et moi | nous deux	pn.
oeyk	cause	n.
ohe	je (forme cérémonielle)	pn.
olo'	clan | groupe	n.
olo'eyktan	leader | meneur | chef (d'un clan)	n.
omum	connaître | savoir	vtr.
ontu	nez | truffe	n.
pähem	arriver	vin.
pak	part. du dénigrement | dépréciation | signe de mépris	part.
pa'li	direhorse | equidus	n.
palulukan	Thanator	n.
pam	son	n.
pamtseo	musique	n.
pamtseowll	[Felinafolia ferruginea]	n.
pängkxo	discuter | converser	vin.
pänutìng	promettre (qqch à qqn)	vtr.
pätsì	badge	n.
pawm	interroger	vtr.
pay	eau	n.
paywll	[Aloeparilus succulentus]	n.
--pe+	que quoi (particule utilisée pour générer une question)	affix
pe'un	décider	vtr.
pefya	comment	inter.
pehem	que | quoi	inter.
pehrr	quand?	inter.
pelun	pourquoi	inter.
peng	dire | raconter	vtr.
penghrrap	[Lucinaria fibriata]	n.
peseng	où? | à quel endroit?	inter.
pesu	qui	inter.
peu	quoi? | quel? | quelle? | quelle chose? | ([quoi pour une chose])	inter.
pey	attendre	vin.
pizayu	ancêtre	n.
plltxe	parler	vtr.
po	Il | elle (sans différence de genre)	pn.
poan	Il (an part. Masculine)	pn.
poe	elle (e part. féminine)	pn.
pongu	groupe	n.
prrnen	enfant | bébé	n.
prrnesyul	bourgeon	n.
prrte'	agréable (pour une activité)	adj.
pxan	digne | méritant	adj.
pxasìk	Fais chier! | Ah zut!	intj.
pxasul	frais (pour de la nourriture)	adj.
pxay	beaucoup | un grand nombre de	adj.
pxey	trois	num.
pxi	pointu | acéré	adj.
pxìm	souvent | fréquemment	adv.
pxiut	[Saltcellar gracilis]	n.
pxorna'	episoth | semence qui explose | [Croquembouche columnare]	n.
pxun	bras	n.
pxuntil	coude	n.
rä'ä	ne pas ([pour les phrases impératives négatives et les ordres seulement])	part.
ral	signification | sens	n.
ralpeng	traduire | interpréter	vtr.
rawke	cri d'alarme | appel à la défense	intj.
rel	image | dessin	n.
reltseo	art (dans le sens 'oeuvre d'art')	n.
reltseotu	artiste	n.
renu	modèle | exemple	n.
rey	vivre	vin.
rikx	bouger | changer de position	vin.
rim	jaune	adj.
rina'	graine | semence	n.
riti	stingbat | [Scorpiobattus volansii]	n.
rol	chanter	v.
ronsem	esprit | intelligence	n.
rum	balle	n.
rumut	puffball tree | [Obesus rotundus]	n.
run	trouver | découvrir	vtr.
rutxe	s'il vous plaît (SVP)	intj.
sa'nok	mère	n.
sa'nu	maman	n.
san	guillemets | [part. au début d'un discours direct ou d'une citation]	adv.
sänume	enseignement | instruction	n.
säspxin	maladie	n.
sempu	papa	n.
sempul	père	n.
set	maintenant	adv.
sevin	joli | mignon ([décrit principalement une femme])	adj.
seyri	lèvre	n.
seze	blue flower | nom de l'ikran de Neytiri	n.
si	[v. auxiliaire]	vin.
sì	et (pour lier deux choses)	part.
sìk	guillemets | [part. à la fin d'un discours direct ou d'une citation]	adv.
sìlpey	espérer	vin.
sìlronsem	intelligent | pratique (le mot anglais est 'clever')	adj.
sìltsan	bon | bien	adj.
ska'a	détruire	vtr.
skxawng	débile | idiot	n.
slä	mais	conj.
slu	devenir	vin.
sngä'i	commencer | débuter	vim.
sngä'ikrr	commencement | départ (au sens temporel)	n.
sngel	ordure	n.
sngeltseng	déchetterie	n.
snumìna	incertain | indécis (pour une personne)	adj.
som	chaud	adj.
somtìlor	popsicle | [Capsulatum virgatum]	n.
spaw	croire	vtr.
spxam	champignon	n.
spe'e	capturer	vtr.
spe'etu	captif	n.
spxin	malade	adj.
srak	[marqueur de question fermée placée en fin de phrase]	part.
srake	[marqueur de question fermée placée en début de phrase]	part.
srane	oui	part., intj.
srew	danser	vin.
srung	aide | assistance	n.
stawm	entendre	vtr.
steftxaw	examiner	vtr.
stum	presque | à peu près	adv.
sutx	traquer | pister | suivre	vtr.
swaw	moment	n.
swey	meilleur	adj.
swirä	creature	n.
swizaw	flèche	n.
swok	sacré	adj.
swotu	place sacrée	n.
syaw	appeler | nommer	vin.
syulang	fleur	n.
ta	de (usages multiples)	adp.
ta'em	d'en haut	adv.
tafral	donc | en conséquent | aussi	adv.
täftxu	tisser	vtr.
täftxuyu	tisserand(e)	n.
takuk	frapper | battre | giffler	vtr.
talioang	sturmbeest	n.
talun	parce que | ([forme abrégée de] taluna)	conj.
taluna	parce que	conj.
tam	suffire | aller	vin., intj.
tam tam		intj.
tangek	tronc (pour un arbre)	n.
tanhì	étoile	n.
taron	chasser	vtr.
taronyu	chasseur	n.
tautral	arbre du ciel	n.
taw	ciel	n.
taweyk	parce que | à cause de	conj.
taweyka	parce que | à cause de	conj.
tawsìp	vaisseau du ciel	n.
tawng	plonger | esquiver	vin.
tawtsngal	panopyra | [Panopyra aerii]	n.
tawtute	Humain | Personne du ciel | Celui qui vient du ciel	n.
te	part. utilisée dans les noms complets	part.
tel	recevoir	vtr.
telem	corde	n.
teng	même | égal	adj.
tengfya	la même manière que | comme | de même façon	conj.
tengkrr	tandis que | en même temps	conj.
teri	concernant | au sujet de	adp.
terkup	mourir	vin.
teswotìng	permettre | accorder	vtr.
teya	plein	adj.
teylu	beetle larvae	n.
tewti	wow | whouah	intj.
til	joint | charnière | gond	n.
tirea	esprit	n.
tireafya'o	chemin spirituel	n.
tireaioang	animal légendaire | esprit animal	n.
tireapängkxo	communier (être en communion au sens spirituel)	v.
tì'eyng	réponse	n.
tìfmetok	test | essai | examen	n.
tìftang	arrêt	n.
tìfyawìntxu	conseil | direction	n.
tìhawnu	protection	n.
tìkangkem	travail	n.
tìkawng	Toruk Makto, idiot	n.
tìkenong	exemple	n.
tìkin	besoin	n.
tìlor	beauté	n.
tìng	donner	vtr.
tìng mikyun	écouter | prêter l'oreille	vin.
tìng nari	regarder	vin.
tìngay	vérité	n.
tìpawm	question	n.
tìran	marcher	vin.
tìyawn	amour	n.
tìrey	vie	n.
tìrol	chant	n.
tìspxin	malade	n.
tìtxur	force	n.
to	[marqueur de comparaison] | ... que ...	part.
tok	occuper (pour une zone) | résider (pour un habitat) | être (pour un emplacement)	vtr.
toktor	médecin	n.
tokx	corps	n.
tompa	pluie	n.
toruk	grand leonopteryx | La dernière ombre	n.
toruk makto	Chevaucheur de Toruk	n.
torukspxam	[Fungimonium giganteum]	n.
trr	jour (au sens temporel)	n.
trram	hier	adv.
tukru	lance	n.
tul	courir	vin.
tung	permettre | autoriser | accorder	vtr.
tupe	qui?	inter.
tut	Marqueur de continuité	part.
tute	femme	n.
tuté	femme	n.
tutan	mâle (personne) | homme | mec	n.
tsa'u	ça | cela	n.
tsaheylu	lien	n.
tsakem	cette action	n.
tsakrr	ce temps | ce moment	adv.
tsam	guerre	n.
tsampongu	guerriers | combattants (le groupe)	n.
tsamsiyu	guerrier | combattant	n.
tsap'alute	excuse	n.
tsatseng	Ici | là | cette place	n.
tsatu	cette personne	n.
tsawke	soleil	n.
tsawl	grand | énorme | gros (pour une envergure taille)	adj.
tsawlapxangrr	[Magellum deltoids] | [Forme abrégée]: tsawlapx	n.
tse'a	voir (au sens physique)	vtr.
tseng	place, endroit	n.
tsenge	place	n.
tsengpe	où?	inter.
tseo	art	n.
tskalep	arbalète	n.
tsko	arc (l'arme)	n.
tsko swizaw	arc et flèches	n.
tskxe	roche | pierre	n.
tskxekeng	exercice | entraînement	n.
tslam	comprendre	vtr.
tsleng	faux	adj.
tslolam	j'ai compris	intj.
tsmuk	enfant de mêmes parents | semblable	n.
tsmuktu	enfants de mêmes parents	n.
tsmukan	frère	n.
tsmuke	soeur	n.
tsnì	que (pour une chose)	sbd.
tsngal	tasse | coupe	n.
tspang	tuer	vtr.
tsranten	importer (avoir de l'importance)	vin.
tstew	brave | courageux	adj.
tstxo	nom	n.
tsun	pouvoir (être capable de )	vim.
tswayon	voler (dans le sens 'voler dans le ciel')	vin.
tsyal	aile	n.
tsyo	farine	n.
tsyorina'wll	Cycad | [Pseudocycas altissima]	n.
txan	plein | beaucoup	adj.
txantsan	excellent | génial | super	adj.
txantslusam	sage	adj.
txe'lan	coeur	n.
txele	matière (sujet)	n.
txen	éveillé	adj.
txep	feu	n.
txewk	bâton | massue (arme)	n.
txey	stopper | arrêter	v.
txìm	l'arrière | l'extrémité | fesses	n.
txìng	quitter | abandonner | laisser	vtr.
txll'u	[Flaska ascendens]	n.
txo	si (dans le sens de la supposition)	conj.
txoa	pardon	n.
txokefyaw	sinon | autrement	conj.
txon	nuit	n.
txopu	peur	n.
txula	construire | fabriquer	vtr.
txum	poison	n.
txumpaywll	[Scorpioflora maxima]	n.
txumtsä'wll	[Flaska reclinata]	n.
txur	fort	adj.
ulte	et (pour connecter deux phrases)	conj.
ultxa	rencontre	n.
unil	rêve	n.
uniltìrantokx	avatar	n.
uniltìranyu	marcheur de rêves	n.
utral	arbre	n.
uvan	jeu	n.
uvan si	jouer	vin.
vay	jusqu'à	adp.
virä	diffuser | proliférer | extendre	v.
vrrtep	démon	n.
vul	branche (pour un arbre)	n.
way	chant ([ancien, cérémonial])	n.
waytelem	accord (musicalement parlant)	n.
win	rapide	adj.
wìntxu	montrer	vtr.
'ewll	plante	n.
wrrpa	extérieur	adv., n.
wutso	dîner | repas	n.
ya	air (de l'air)	n.
yawne	bien-aimé(e) | ([parfois] cher(s)/chère(s))	adj.
ye'rìn	bientôt	adv.
yerik	hexapède	n.
yey	droit | rectiligne	adj.
yìm	lier | attacher	vtr.
yol	court (temps) | bref	adj.
yom	manger	vtr.
yomhì'ang	dakteron | 'insectivore' | [Pseudopenthes coralis]	n.
yomioang	chalice plant  | [Pseudocenia rosea]	n.
yomtìng	alimenter | nourrir	vin.
yur	laver	vtr.
za'ärìp	tirer ([contraire de] pousser)	vtr.
za'u	venir	vin.
zamunge	apporter	vtr.
zawng	hurler	vin.
zekwä	doigt	n.
zene	devoir (obligation)	vim.
zìsìt	année	n.
zong	sauver | sauvegarder	vtr.
zongtseng	abri | refuge	n.
zoplo	offense | insulte	n.
zoplo si	offenser qqn | insulter qqn | blesser qqn	vin.
zusawkrr	futur | dans le futur	n.
Jakesully	Toruk Makto, idiot	n.
'ärìp	bouger  | déplacer (quelque chose)	vtr.
'awstengyem	lier (deux choses ou plus ensemble)	vtr.
'efu	(se) sentir | percevoir | ressentir	vtr.
'em	cuisiner	vtr.
'eyng	répondre	vin.
'i'a	finir | conclure	vin.
'ia	se perdre (spirituellement)	vin.
fkxake	démanger	v.
fmal	soutenir	vtr.
frìp	mordre	vtr.
ftem	passer ([près de quelque chose])	vtr.
fwew	chercher | rechercher	vtr.
hangham	rire	vin.
vaykrr	jusqu'à ([temps])	conj.
sngap	piquer	vtr.
hawl	préparer	vtr.
kä'ärìp	pousser	vtr.
kavuk si	trahir	vin.
kllkä	descendre	vin.
latsi	continuer/maintenir avec quelqu'un	v.
lek	obéir | tenir compte	vtr.
len	se passer | avoir lieu | se produire	vin.
lew si	couvrir	vin.
muntxa si	joindre | unir | s'accoupler	vin.
näk	boire	vtr.
nong	suivre | avoir lieu après	vtr.
oeyktìng	expliquer pourquoi	vtr.
pate	arriver (dans le sens 'arriver quelque part')	v.
piak si	ouvrir	vin.
pom	embrasser	vtr.
pxor	exploser	vin.
salew	aller | procéder | ([également utilisé pour dire l'âge d'une personne])	v.
sar	utiliser	vtr.
sim	être près de	vin.
sleyku	produire	vtr.
sop	voyager	vin.
spä	sauter	v.
speng	restaurer | reconstituer	vtr.
spule	propulser	vtr.
srese'a	prédire	vtr.
steyki	énerver | agacer	vtr.
sti	être en colère	vin.
sto	refuser (de faire quelque chose)	vtrm.
sung	ajouter | additionner | assembler	vtr.
syep	piéger	vtr.
tatep	perdre	vtr.
tätxaw	retourner	vin.
tem	tirer ([avec une arme])	vin.
tì'awm si	camper	vin.
tì'awm	camping	n.
tìkangkem si	travailler	vin.
tìng tseng	se retirer	vin.
tìsraw seyki	blesser quelqu'un | faire mal à quelqu'un	vtr.
tìsraw	douleur	n.
tìsraw si	être douloureux | faire mal	vin.
toltem	décocher | tirer	vtr.
tsä'	jaillir	v.
tsaheyl si	lier (établir une connexion neurale)	vin.
tsap'alute si	s'excuser	vin.
tsawl slu	grandir | croître | devenir grand	vin.
tsngawvìk	pleurer	vin.
tsre'i	lancer	vtr.
tstu si	fermer	vin.
tsunslu	être possible	vin.
tsurokx	reposer	vin.
tungzup	déposer | lâcher	vtr.
wem	combattre	vin.
win säpi	se dépêcher	vin.
win si	faire rapidement	vin.
yän	attacher	vtr.
yem	mettre | placer	vtr.
zenke	ne pas devoir (obligation)	vim.
zup	tomber	vin.
nekll	bas (direction)	adv.
srung si	aider	vin.
txopu si	être appeuré	vin.
fkip	chez | parmi	adp.
io	au-dessus (de) | au dessus (de)	adp.
kxamlä	par | à travers	adp.
lok	près de | proche de	adp.
maw	après (au sens temporel)	adp.
mìkam	entre	adp.
nemfa	dans | à l'intérieur	adp.
pxaw	autour de	adp.
pxel	comme | ainsi que	adp.
sìn	sur	adp.
takip	d'eux	adp.
uo	derrière (position)	adp.
luke	sans	adp.
tafkip	de l'un d'entre eux	adp.
ro+	au | à (dans le sens 'Au kelutral' 'À Hell's Gate')	adp.
sre+	avant (au sens temporel)	adp.
wä+	contre (dans le sens 'se battre contre quelque chose')	adp.
fäpa	sommet | haut | début	n.
alìm	lointain | à une distance éloignée	adv.
aylaru	aux autres	pn.
kxu	mal | dommage	n.
eltu lefngap	ordinateur	n.
kì'ong	lent	adj.
säfpìl	idée	n.
kefyak	n'est-ce pas?	part.
prrwll	mousse	n.
pängkxoyu lekoren	avocat | juriste | Homme de Loi	n.
pamrel	écriture | document écrit	n.
pamrel si	écrire | (permet le double datif)	vin.
furia	que (marqueur de subordination)	sbd.
fratseng	partout	adv.
fratrr	quotidiennement | (à) tous les jours	adv.
frato	marqueur superlatif (dans le sens 'plus que tout')	part.
trray	demain	adv.
kea	aucun ([devant un nom])	adj.
ngian	cependant	adv.
skepek	formel	adj.
hufwa	bien que...	conj.
tup	au lieu de | plutôt que	conj.
'uo	quelque chose	pn.
tuteo	quelqu'un	pn.
tsengo	quelque part (dans le sens indéfini du truc)	pn.
holpxaype	combien	inter.
hìm	petit (pour une quantité)	adj.
hìmtxampe	combien	inter.
hìmtxan	quantité	n.
pìmtxan	combien	inter.
lì'upe	quoi ? | quel (mot) ? | quelle (parole) ?	inter.
pelì'u	quel (dans le sens 'quel mot?' 'quelle expression?')	inter.
ultxarun	rencontrer (par hasard)	vtr.
ultxa si	rencontrer (intentionnellement)	vin.
rangal	souhaiter (que [devient] tsnì [pour introduire la subordonnée])	vin.
nìrangal	en souhaitant que (contraire au fait, | en utilisant le subjonctif ou le 'perfective')	adv.
txepvi	étincelle	n.
nitram	joyeux (pour des gens)	adj.
fewi	poursuivre	vtr.
stä'nì	attraper	vtr.
sran	oui (langage familier) | ouais | ouaip	part., intj.
weyn	dessiner | illustrer	vtr.
fìtrr	aujourd'hui | (en) ce jour	adv.
rusey	vivant	adj., n.
vitra	âme	n.
nìzawnong	sans danger	adv.
ftawnemkrr	passé (le passé)	n.
txal	dos (la partie anatomique d'un corps)	n.
tsìng	4 (quatre)	num.
mrr	cinq	num.
pukap	six	num.
kinä	sept	num.
vol	huit	num.
zam	64 (soixante quatre)	num.
tìoeyktìng	explication	n.
lesar	utile	adj.
tse	Ben... | Tu sais... | Écoutez... | Enfin...	part.
skxom	chance | opportunité	n.
fkxen	végétal ([nourriture]) | 'légume'	n.
syä'ä	amer	adj.
yemfpay si	immerger	vin.
yemfpay	immersion	n.
keng	même | autant que	adv.
'awlo	une fois	adv.
melo	deux fois	adv.
heyn	s'asseoir	vin.
nìpxim	correctement	adv.
pxim	intègre | droit	adj.
tuvon	appuyer	v.
nìfya'o	d'une manière	adv.
letrrtrr	ordinaire | quelconque	adj.
nì'eoio	cérémonieusement	adv.
'eoio	cérémonieux	adj.
rìk	feuille	n.
lerìk	feuillu	adj.
pa'o	côté	n.
kllpa	arrière (l'arrière)	n.
mìfa	dans | dedans	adv., n.
nefä	haut (direction)	adv.
zapxì	avant (pour un lieu objet)	n.
käpxì	arrière (l'arrière)	n.
käsatseng	là-bas	adv.
ftxey	choisir	conj.
ngaytxoa	je suis désolé | je m'excuse | toutes mes excuses	intj.
flew	gorge	n.
kxa	bouche	n.
nikre	cheveu	n.
pewn	cou | nuque	n.
re'o	tête	n.
sre'	dent	n.
tsuksìm	menton	n.
key	visage	n.
puk	livre	n.
ngäng	estomac	n.
ta'leng	peau	n.
tsyokx	main	n.
reypay	sang	n.
tsopì	poumon	n.
venu	pied	n.
venzek	orteil	n.
ramunong	puits	n.
payfya	ruisseau	n.
pxawpa	bords | périmètre	n.
txampay	océan | mer	n.
'ora	lac	n.
ekxan	barricade | barrière | clôture	n.
tsim	source	n.
tsray	village	n.
txayo	champ | plaine | terrain dégagé	n.
ukxo	sec	adj.
wew	froid	adj.
fìtxon	ce soir	adv., n.
txonam	hier soir | la nuit dernière	adv.
txonay	demain soir | la nuit prochaine	adv.
sekrr	présent	n.
vur	histoire	n.
tìpängkxo	conversation | discussion	n.
tìsrese'a	prophétie	n.
nawmtu	Grande Personne	n.
txantstew	héros	n.
syuve	nourriture ([nom collectif et indénombrable])	n.
tsngan	viande	n.
tstal	couteau	n.
tete	émoussé (ex: une lame)	adj.
lew	couvercle | couverture	n.
'opin	couleur	n.
leNa'vi	concernant les Na'vi | concernant le Peuple	adj.
nìNa'vi	comme un Na'vi | de la manière des Na'vi	adv.
hapxìtu	membre	n.
'Rrta	Planète Terre	prop.n.
fwäkìwll	mante orchidée | [Pandorchidus insectoralis]	n.
hì'ang	insecte	n.
payoang	poisson	n.
yayo	oiseau	n.
zize'	guêpe hellfire	n.
kemlì'u	v.	n.
tstxolì'u	nom	n.
ftär	gauche (la gauche)	adj.
skien	droite (la droite)	adj.
'änsyem	achevé | terminé	adj.
wotx	totalité	n.
mowan	plaisant | agréable ([physiquement, sexuellement])	adj.
vä'	infect | désagréable pour les sens	adj.
tatlam	apparemment	adv.
keteng	différent	adj.
numtseng	école	n.
skxakep	probable | probablement	adj., adv.
tìprrte'	plaisir	n.
kaw'it	du tout	adv.
nìlkeftang	constemment | continuellement | en permanence	adv.
tì'i'avay	jusqu'à la fin	adv.
'awm	camp	n.
tìska'a	destruction	n.
tìsop	voyage	n.
wempongu	escadron | groupe de combattant	n.
asim	proche	adv.
klltseng	position	n.
kxutu	ennemi	n.
mekre	vivres | approvisionnement | fourniture	n.
tìhawl	préparation	n.
tìkan	but | cible | objectif	n.
tìpähem	arrivée	n.
numeyu	étudiant | élève	n.
soaia	famille	n.
tìmuntxa	mariage | accouplement	n.
yawnetu	amour | aimé(e) pour une personne | dans le sens mon amour | mon aimé(e)	n.
yawntu	cher(e) pour une personne | dans le sens mon cher(e)	n.
kakrel	aveugle	adj.
kanu	brillant | intelligent	adj.
koak	vieux | âgé ([pour les êtres vivants])	adj.
lekye'ung	fou	adj.
me'em	harmonieux	adj.
txanew	gourmand	adj.
txantur	puissant	adj.
tì'awpo	individualisme | égoïsme (dans le sens négatif)	n.
tì'eylan	amitié	n.
fkay	odieux	adj.
keltsun	impossible	adj.
kxuke	sauf	adj.
lehawng	excessif	adj.
hawng	surabondance	n.
lekin	nécessaire	adj.
stxong	étrange | inconnu | non familier | ([pour quelque chose qui semble menaçant ou dangereux])	adj.
syen	final | dernier ([d'une série])	adj.
kavuk	traîtrise	n.
fpìlfya	réflexion | manière de penser	n.
syay	sort | destin	n.
tìfnu	silence	n.
tìngop	création	n.
tìpe'un	décision	n.
kxitx	mort | décès	n.
trr'awve	dimanche (premier jour)	n.
trrmuve	lundi (deuxième jour)	n.
trrpxeyve	mardi (troisième jour)	n.
trrtsìve	mercredi (quatrième jour)	n.
trrmrrve	jeudi (cinquième jour)	n.
trrpuve	vendredi (sixième jour)	n.
trrkive	samedi (septième jour)	n.
'ango	doux ([son])	adj.
kxayl	haut	adj.
rey'eng	La Balance de la Vie	n.
tìme'em	harmonie (au sens général)	n.
fnel	type | sorte	n.
fnepe	quel sorte	inter.
pefnel	quel type | quelle sorte	inter.
zerok	se souvenir de	vtr.
tswa'	oublier	vtr.
tì'efu	sentiment	n.
maweypey	être calme | patient	vin.
tìmweypey	patience	n.
lemweypey	patient ([dans le sens 'quelqu'un de patient'])	adj.
nìmweypey	patiemment	adv.
tsakrrvay	jusque là | entre-temps	adv.
ohakx	affamé	adj.
tìohakx	faim	n.
tsyosyu	nourriture (faite à partir de farine)	n.
vey	aliments à base de chair	n.
trrpeve	quel jour ?	inter.
pxiswawam	il y a un instant (dans le sens 'Ca s'est passé il y a un instant')	adv.
pxiset	maintenant | tout de suite	adv.
pxiswaway	dans un instant (dans le sens 'Ca se passera dans un instant')	adv.
pxiye'rìn	diviser	adv.
pxisre+	juste avant	adp.
pximaw	juste après	adp.
sok	récent	adj.
'awlie	une fois (dans le passé)	adv.
tìkxey	inexactitude	n.
tìkxey si	faire erreur	vin.
tìyawr	exactitude	n.
tìketeng	différence	n.
fpomtokx	santé (au sens physique)	n.
lefpomtokx	bien portant | en bonne santé	adj.
kelfpomtokx	malade | en mauvaise santé	adj.
keftxo	malheureux	adj., intj.
nìkeftxo	malheureusement	adv.
sraw	douloureux	adj.
txampxì	majorité	n.
vurvi	résumé	n.
sänumvi	leçon	n.
letam	suffisant	adj.
letsranten	important	adj.
nìswey	optimum | de façon optimale	adv.
nìpxi	directement (dans le sens 'sans ambiguité')	adv.
wok	bruyant	adj.
spuwin	vieux ([pour un objet]) | ancien/antérieur	adj.
nì'eyng	en retour | en réponse	adv.
nìkanu	intelligemment	adv.
nìlaw	clairement	adv.
tìsti	colère	n.
tìtxanew	avidité	n.
tìftxey	choix	n.
tìkanu	intelligence	n.
tìlam	apparence	n.
tìtslam	compréhension	n.
tìtxula	construction	n.
hewne	doux (pour un objet)	adj.
tìm	bas	adj.
laro	propre	adj.
tsewtx	sale	adj.
lefngap	métallique	adj.
txa'	dur	adj.
fwel	cassé	adj.
etrìp	favorable | propice	adj.
piak	ouvert	adj.
tstu	fermé	adj.
kxll si	charger | attaquer en courant sur sa cible	vin.
tsaw	cette (chose) | [Forme abrégée de]: tsa'u	pn.
tsalsungay	néanmoins | malgré tout	adv.
oìsss	cri de mécontentement (dans le sens 'Gaff!!' 'Attention!!')	intj.
saa	cri de menace	intj.
sau	exclamation pendant un effort | une action	intj.
tsahey	cri d'avertissement | frustration	intj.
wiya	cri d'avertissement | frustration	intj.
ìley	[cri de guerre]	intj.
vawm	sombre	adj.
tìvawm	ténèbre	n.
polpxay	combien	inter.
ke'aw	divisé | déchiré (pour un groupe)	adj.
nìsti	avec colère (dans le sens 'dire faire... avec colère')	adv.
teyr	blanc	adj.
layon	noir	adj.
pänu	serment | promesse	n.
kew	0 (zéro)	num.
'eyt	([le symbole]) 8 | ([pas sa valeur])	n.
nayn	neuf (le symbole '9')	n.
trr'ong	aube | aurore	n.
trr'ongmaw	aube | aurore (après le lever du soleil)	n.
rewon	matin	n.
srekamtrr	avant midi	n.
kxamtrr	midi	n.
kxamtrrmaw	début d'après-midi	n.
ha'ngir	après-midi	n.
kaym	soir (avant le crépuscule)	n.
sreton'ong	crépuscule	n.
txon'ong	soir | crépuscule	n.
txon'ongmaw	crépuscule | crépuscule astronomique	n.
srekamtxon	avant minuit	n.
kxamtxon	minuit	n.
kxamtxomaw	après minuit	n.
sresrr'ong	avant l'aube | avant l'aurore	n.
wou	être étonnant | être fascinant	vin.
tsyìräfì	girafe	n.
tsawa	ce	sbd.
tsata	que	sbd.
tsaria	que	sbd.
alo	fois	n.
fralo	chaque fois | tout le temps	adv.
nìmwey	calmement	adv.
ku'up	lourd ([poids physique])	adj.
syo	léger (au sens physique)	adj.
hay	suivant | prochain	adj.
ham	précédent	adj.
matsa	crakers (Mot hébreu 'matza')	n.
hametsì	pain au levain	n.
tìkangkemvi	projet | partie d'un travail	n.
nì'i'a	finalement | enfin	adv.
nìsyen	dernièrement	adv.
pìlok	blog	n.
tsulfätu	maître | expert	n.
tsulfä	maîtrise	n.
tsulfä si	maitriser	vin.
numtsengvi	classe	n.
rofa	à côté de | le long de	adp.
pum	Celui, celle (avec un déterminant) | [Pronom substitutif qui réfère à un nom ou un pronom mentionné antérieurement.]	pn.
Yuesey	États-Unis	prop.n.
teya si	remplir	vin.
alunta	parce que | ([précédé par la subordonée])	conj.
nìprrte'	agréablement (ou l'adv. 'bienvenue')	adv.
sngä'iyu	débutant	n.
srekrr	avant | auparavant	adv.
ayu	choses	n.
tsafya	comme ça	adv.
muve	second	adj.
pxeyve	troisième	adj.
tsìve	quatrième	adj.
mrrve	cinquième	adj.
puve	sixième	adj.
kive	septième	adj.
volve	huitième	adj.
tsyänel	canal | chaîne	n.
trrtxon	jour & nuit (le cycle complet d'une rotation Pandorienne)	n.
au	[exclamation de consternation]	intj.
pängkxoyu	personne participant à une discussion	n.
lekoren	règlementé | règlementaire	adj.
prrkxentrrkrr	plaisir diurne de fumer, vibration de la langue	n.
tìftia	étude	n.
tìftia kifkeyä	science | étude du monde	n.
pxir	bière	n.
eanean	(plante herbacée) | [Thylakoidia spiralis]	n.
'ele'wll	Plante comparable à un cactus | [Sigmoidia barbata]	n.
tstxa'a	Canalyd | [Canalydium limacineum]	n.
pa'liwll	direhorse pitcher plant | [Pseudocenia equina]	n.
anìheyu	plante spirale bleue | [Orbis caeruleus]	n.
tompawll	[Tubineus azureus]	n.
pxiwll	hermit bud plant | [Cynaroidia discolor]	n.
syeptute	[Pandoratonia myopora]	n.
kllpxiwll	([fruit ressemblant à un artichaut]) | Cynaroidia decumbens	n.
smaoe	[Phalanxia ferox]	n.
'ä'o	Pitcher plant | [Plantapurpurea cordata]	n.
mulpxar	roosterhead plant | [Alectophyllum molle]	n.
flefle	Sol's delight | Plante magnétotrophique | [Calamariphyllum elegans]	n.
kxaylte	plante herbacée | Clawenia purpurea	n.
fkxakewll	plante piquante | [Cynaroidia glauca]	n.
tìhawnuwll	spartan | [Kuchenium polyphyllum]	n.
pxorna'lor	sari | belle plante de semence qui explose | [Pandargonium cyanellum]	n.
pxayzekwä	spiny whips | [Phytotinium poydactylum]	n.
mìnyu	'plante-animal' | 'tourneur' | [Pseudolilium contortum]	n.
väfewll	Centipede | [Scolopendra virens]	n.
sngukx	[Limacina erecta]	n.
rawp	bladder polyp | [Polypiferus brevisimus]	n.
'ampirikx	feuilles de la Pitcher plant | [Pseudocenia simplex]	n.
apxangrr	[Magelum triangulare]	n.
värumut	[Obesus fenestralis]	n.
keyawr	incorrect	adj.
lehrrap	dangereux	adj.
tìtxen	éveil	n.
hìrumwll	puffer plant	n.
fwäkì	mante	n.
fratxon	toutes les nuits	adv.
hìkrr	seconde | temps très court	n.
mawkrr	après | ultérieurement	adv.
ngeyn	fatigué	adj.
ngopyu	créateur	n.
nìk'ong	lentement | tranquillement	adv.
pamtseotu	musicien	n.
sat	ça (lénition de tsat)	pn.
tsal	ça | cela | cette (chose) | ([en tant que sujet d'un vtr.]) | Forme abrégée de: [tsa'ul]	pn.
tsat	ça | cela | cette (chose) | ([en tant que complément direct d'un vtr.]) | [Forme abrégée de]: tsa'ut	pn.
tsawlhì'	taille	n.
lì'fyavi	expression | morceau de langage	n.
nafì'u	tel | pareil	adj.
lì'fyaolo'	utilisateurs de la langue	n.
puktsyìp	livret	n.
utraltsyìp	buisson (forme diminutive de 'arbre')	n.
säspxintsyìp	indisposition	n.
'itetsyìp	petite fille (terme affectueux)	n.
sa'nutsyìp	petite maman (terme affectueux)	n.
kem si	faire	vin.
tswin	tresse | natte | queue	n.
tswintsyìp	petite tresse, natte queue	n.
taronyutsyìp	petit chasseur	n.
oetsyìp	petit moi	pn.
ngatsyìp	petit toi, toi petit	pn.
atanvi	rayon ([de lumière])	n.
txeptsyìp	cher ou petit feu mignon	n.
tìkusar	enseignement	n.
tìyusom	l'acte de manger	n.
tìtusaron	chasse	n.
tìpängkxotsyìp	petite conversation	n.
hayalo	la prochaine fois	adv.
hamalo	la fois précédente	adv.
tstunwi	gentil | aimable	adj.
seykxel	fort ([émotionellement, spirituellement])	adj.
fuke	... ou non	conj.
'a'aw	quelque(s)	adj.
'okrol	histoire (ancienne)	n.
'okvur	histoire (récente)	n.
alu	qui est | en d'autres mots	conj.
fnawe'	peureux | lâche	adj.
fnawe'tu	lâche	n.
ftxìlor	délicieux | de bon goût	adj.
ftxìvä'	mauvais | dégueulasse	adj.
fyeyn	adulte | mature	adj.
fyeyntu	adulte	n.
tìfyeyn	maturité	n.
hawngkrr	en retard	adv.
lehawngkrr	tard	adj.
leye'krr	tôt	adj.
hek	être curieux | étrange	vin.
nìhek	étrangement | curieusement	adv.
ki	mais plutôt | mais au lieu	conj.
nìfyeyntu	comme un adulte	adv.
nì'eveng	comme un enfant	adv.
lìng	planer | flotter dans les airs	vin.
ram	montagne	n.
muntxatu	époux | épouse (sans distinction de genre)	n.
muntxatan	époux	n.
muntxate	épouse	n.
netrìp	heureusement	adv.
newomum	être curieux | vouloir savoir	vin.
lenomum	curieux	adj.
tìnomum	curiosité	n.
ngäzìk	dur | difficile	adj.
tìngäzìk	difficulté | problème	n.
nìsung	de plus | en outre | aditionnellement	adv.
reng	superficiel (au sens physique)	adj.
rolun	Eurêka! | J'ai trouvé!	intj.
sa'sem	parent	n.
smar	proie | élément chassé	n.
starsìm	collecter | assembler	vtr.
sunu	être plaisant | agréable	vin.
syayvi	chance | fortune	n.
nìsyayvi	chanceusement | par chance	adv.
tolel	j'ai pigé	intj.
txukx	profond (au sens physique)	adj.
ve'kì	détester	vtr.
tìve'kì	haine	n.
yaymak	déroutant | embrouillant | ignorant	adj.
ye'krr	en avance	adv.
zìsìkrr	saison	n.
zo	être bien | intacte | être comme ça doit être	vin.
zoslu	guérir | recouvrer ses forces	vin.
zeyko	soigner | guérir | ([causatif de] zo)	vtr.
frawzo	tout va bien | OK	intj.
kemlì'uvi	infixe	n.
irayo si	remercier	vin.
lefkrr	courant | actuel (au sens temporel)	adj.
lì'upam	accent | prononciation	n.
natkenong	par exemple	conj.
eltur tìtxen si	être intéressant | intriguer	vin.
pxelo	trois fois	adv.
pamrelfya	orthographe	n.
law si	éclaicir | clarifier | élucider | ([permet le double datif])	vin.
naer	boisson | chose potable	n.
atxkxerel	carte	n.
nìtengfya	comme | de la même façon que	adv.
tun	rouge | orange	adj.
'om	violet | pourpre | magenta | mauve	adj.
neyn	claire (dans le sens 'une couleur claire')	adj.
ngul	gris | terne	adj.
tumpin	la couleur rouge | la couleur orange	n.
eampin	la couleur bleue | la couleur verte	n.
rimpin	la couleur jaune	n.
'ompin	la couleur violette, pourpre, magenta	n.
layompin	le noir	n.
teyrpin	le blanc	n.
vawmpin	couleur sombre	n.
neympin	couleur claire	n.
ngulpin	le gris	n.
pil	rayure faciale (désigne le motif dessiné par les rayures des visages Na'vi et Avatar)	n.
ta'lengean	bleue-peau (dans le sens 'ce truc est bleu-peau pas bleu-ciel...')	adj.
rìkean	vert feuille	adj.
kllvawm	marron	adj.
'evan	garçon (langage familier)	n.
'eve	fille (langage familier)	n.
'evengan	garçon	n.
'evenge	fille	n.
fkio	tétrapteron | ([animal de Pandora semblable à un flamant rose])	n.
kenten	lézard éventail | fan lizard	n.
nìwä	inversement	adv.
pìwopx	nuage	n.
ramtsyìp	colline	n.
syaksyuk	prolemuris	n.
tor	dernier | ultime | terminal	adj.
txärem	os	n.
uk	ombre	n.
yapay	brume | brouillard | vapeur	n.
tìspe'e	capture	n.
tìftxavang	passion	n.
tìtstunwi	bonté | bienveillance	n.
stxeli	cadeau | présent	n.
ngrrpongu	mouvement populaire	n.
smon	être familier	vin.
lawk	parler de	vtr.
hìtxoa	pardonnez-moi | excusez-moi	intj.
mäkxu	interrompre | briser l'harmonie	vtr.
hultstxem	gêner | retarder	vtr.
mok	proposer | suggérer	vtr.
muwìntxu	présenter | introduire	vtr.
kan'ìn	se concentrer | s'intéresser	vtr.
tìwusem	bagarre, combat	n.
nì'eng	pareillement | également	adv.
Pari	Paris	prop.n.
tì'ong	éclosion | floraison	n.
tìmok	suggestion	n.
tì'em	la cuisine (dans le sens 'l'art de cuisiner')	n.
leyn	répéter	vtr.
päsketpol	basket-ball	n.
nìFranse	en français	adv.
nìToitsye	en allemand	adv.
nìno	en détail | complètement	adv.
hìno	fin | précis | détaillé	adj.
leno	direct (pour une personne)	adj.
tìno	perfection	n.
'ongokx	naître | (être né)	vin.
nokx	mettre au monde	vtr.
nìtrrtrr	régulièrement	adv.
tìn	activité prenante (dans le sens 'une activité qui vous occupe')	n.
txin	premier | primaire | principal	adj.
txintìn	occupation | activité principale (dans le sens 'ton activité principale au sein du Clan')	n.
'emyu	cuisinier	n.
vewng	s'occuper de | prendre soin de	vtr.
kaltxì si	saluer | accueillir	vin.
sopyu	voyageur	n.
fula	que (marqueur de subordination)	sbd.
tskxekeng si	entrainer	vin.
way si	chanter	vin.
swawtsyìp	petit moment, seconde	n.
käteng	passer du temps avec	vin.
'ìn	être occupé	vin.
Sweriye	Suède	prop.n.
nìfkrr	récemment | dernièrement	adv.
sulìn	être occupé (dans le sens positif du truc être occupé par une activité plaisante)	vin.
vrrìn	être occupé (dans le sens négatif du truc)	vin.
tìk'ìn	temps libre	n.
säsulìn	hobby | passe-temps	n.
'o'	apportant du plaisir | amusant | excitant	adj.
Europa	Europe	prop.n.
skxaypxe	Skype	n.
pxorpam	consonne éjective	n.
tì'o'	excitation	n.
nì'o'	agréablement	adv.
fnan	être bon à	vtr.
wätx	être mauvais à	vtr.
tìsom	chaleur	n.
tìwew	froid | froideur	n.
tìlen	évènement	n.
nìnäk	en buvant (dans le sens 'en buvant quelque chose')	adv.
nìhay	ensuite | après	adv.
sayrìp	beau (pour un homme)	adj.
letokx	physique | corporel	adj.
säzärìp	rêne | bride	n.
ìpxa	fougère	n.
tìhawnu si	protéger	vin.
sno	[pronom réfléchi à la 3ième personne] | se | soi-même | lui-même | elle-même | eux-mêmes	pn.
kìte'e si	servir	vin.
var	continuer	vim.
nìftxan	tellement (dans le sens 'à un point tel que')	adv.
Yeysu	Jésus	prop.n.
lelì'fya	langue | langage	adj.
takrra	depuis (au sens temporel)	conj.
akrrta	depuis ([précédé par la subordonnée])	conj.
few	à travers | au travers | au delà	adp.
fewtusok	opposé | l'autre côté/le côté opposé	adj.
sla'tsu	décrire	vtr.
tìsla'tsu	description	n.
'en	conjecture | intuition	n.
'en si	deviner	vin.
le'en	intuitif (pour une chose)	adj.
nì'en	faire une action éclairée | agir sur une intuition	adv.
sä'o	outil | ustensile	n.
pamtseo si	jouer de la musique	vin.
väng	assoiffé	adj.
tìväng	soif	n.
sngum	ennui | souci | tracas	n.
nìsngum	inquiétant	adv.
yayayr	confusion	n.
wäte	argumenter | débattre	vtr.
tìwäte	dispute | querelle | argumentation	n.
säwäte	point de discorde (dans le sens 'un point de discorde')	n.
lewäte	désagréable | [argumenté dans un but qui est autre que la recherche pour la vérité]	adj.
nìwäte	désagréablement	adv.
li	déjà	adv.
lisre+	avant, jusqu'à	adp.
ronsrelngop	imaginer	vtr.
ronsrel	imagination	n.
tìronsrel	imgaination	n.
txanatan	brillant | lumineux | éclatant	adj.
leronsrel	imaginaire	adj.
nìronsrel	imaginairement (dans le sens 'par l'imagination')	adv.
srefey	s'attendre	vtr.
mawl	moitié	n.
pan	tiers | un tiers	n.
wan	cacher | dissimuler	vtr.
nìwan	secrètement | en secret	adv.
tìwan	dissimulation	n.
letwan	douteux | sournois ([pour une personne])	adj.
slele	nager	vin.
nìslele	nageant | à la nage	adv.
tìtaron	chasse (l'activité)	n.
ìì	[hésitation] | euh... | hum...	intj.
tsukyom	comestible	adj.
ketsuktswa'	inoubliable	adj.
tsuktswa'	oubliable	adj.
yafkeyk	temps | météo	n.
fkeytok	exister	vin.
tìfkeytok	existence | condition | situation	n.
tompameyp	bruine	n.
tskxaytsyìp	grêle	n.
tskxepay	glace	n.
herwì	neige	n.
tomperwì	neige fondue | pluie mèlée de neige	n.
txanfwerwì	blizzard	n.
hermeyp	bourrasque de neige	n.
hertxayo	champ de neige	n.
ìlva	flocon | goutte | éclat	n.
txepìva	cendre	n.
herwìva	flocon de neige	n.
payìva	goutte d'eau	n.
tompìva	goutte de pluie	n.
kintrr	semaine	n.
mrrtrr	semaine (dans le sens 'semaine de travail')	n.
muntrr	weekend | fin de semaine	n.
kintrram	la semaine précédente | la semaine passée	n.
kintrray	la semaine suivante | la semaine prochaine	n.
muntrram	le weekend précédent | le weekend passé	n.
muntrray	le weekend suivant | le weekend prochain	n.
vospxì	mois	n.
vospxìam	mois précédent | mois dernier	n.
vospxìay	mois suivant | mois prochain	n.
sweylu	devoir ([au conditionnel présent; suggestion]) | ([suivi de] txo)	vin.
ye	satisfait | content	adj.
hasey si	accomplir | mener à terme	vin.
seysonìltsan	bien joué | yeah | cool	intj.
yehakx	rassasié	adj.
yeväng	désaltéré	adj.
somwew	température	n.
pup	petit | court (pour une longueur physique)	adj.
ngimpup	longueur	n.
pesomwew	quelle température?	inter.
somwewpe	quelle température?	inter.
txawew	glacé | glacial	adj.
wur	frais | froid	adj.
tsyafe	doux | tempéré | modéré	adj.
sang	tiède | chaud	adj.
txasom	brûlant | bouillant	adj.
leyapay	brumeux	adj.
lepwopx	nuageux	adj.
nìhol	peu | pas beaucoup	adv.
nìpxay	beaucoup	adv.
paynga'	humide | moite	adj.
meuianga'	honorable	adj.
txumnga'	empoisonné	adj.
'akra	terre ([fertile])	n.
hufwetsyìp	brise | zéphyr	n.
nìlam	aparemment | en apparence	adv.
nìli	en avance	adv.
nìfrakrr	comme toujours	adv.
am'a	doute	n.
nga'	contenant (le nom)	vtr.
tìftang si	arrêter (quelqu'un)	vin.
may'	évaluer | tester	vtrm.
yora'	gagner (une bataille, une partie)	vtr.
snaytx	perdre (une partie, une bataille)	vtr.
tìyora'	victoire	n.
tìsnaytx	perte	n.
'otxang	instrument de musique (terme générique)	n.
skxir	blessure	n.
leskxir	blessé	adj.
skxir si	blesser | meurtrir	vin.
skxirtsyìp	meurtrissure | contusion	n.
sloan	verser	vtr.
emrey	survivre	vin.
temrey	survivant (la personne)	n.
lemrey	survivant (d'un groupe)	adj.
nemrey	comme si sa vie était en jeu	adv., intj.
wawe	importance | signifiance	n.
txanwawe	important | signifiant	adj.
nìwawe	plein de sens | d'une façon significative	adv.
keyrel	expression faciale ([dans le sens 'les expressions du visage'])	n.
fwampop	tapirus | ([animal semblable à un tapir])	n.
säplltxe	énoncé | exposé | rapport	n.
säplltxevi	commentaire	n.
kawtseng	nulle part	adv.
tsapo	celui-là | celle-là | celui-ci | celle-ci (pour des personnes)	pn.
fwefwi	siffler	vin.
'etnaw	épaule	n.
pllngay	admettre | avouer | reconnaître	vin.
kawngsar	exploiter | profiter	vtr.
lom	perdue | manquant | absent (dans le sens 'une personne manquante')	adj.
koaktan	vieil homme	n.
koakte	vieille femme	n.
koaktu	vieille personne	n.
lomtu	personne manquante	n.
fe'	mauvais	adj.
nìfe'	mal (dans le sens 'faire mal qqch', 'faire d'une mauvaise manière qqch')	adv.
wätu	adversaire | rival | opposant	n.
fekem	accident	n.
hawtsyìp	sieste | somme	n.
uran	bateau | embarcation	n.
ftxozä si	célébrer | fêter	vin.
kekem	aucune action | aucune activité | rien	pn., adv.
pxen	vêtement	n.
tewng	pagne	n.
raspu'	jambière | protection de jambe (utilisé pour le combat)	n.
hawnven	chaussure | soulier	n.
hawntsyokx	gant	n.
hawre'	chapeau	n.
ioi	ornement | parure (au sens cérémoniel)	n.
nìlun	bien sûr | logiquement | selon le bon sens	adv.
'ali'ä	collier	n.
'are	poncho | cape | châle	n.
fkxile	collier pectoral	n.
masat	armure | cuirasse (dans le sens 'un élément de protection corporelle')	n.
nikroi	serre tête | parure de cheveux	n.
pxawpxun	brassard | protection de bras	n.
renten	lunettes | protection oculaire | ([faites à l'aide d'ailes d'insectes, taillés dans le bois, etc.])	n.
tsamopin	pinture de guerre	n.
tsang	piercing	n.
miktsang	boucle d'oreille	n.
ontsang	boucle de nez | ornement nazal | piercing sur le nez	n.
yemstokx	revetir | endosser | porter (pour des vêtements)	vtr.
ioi si	décorer	vin.
'aku	enlever	vtr.
le'aw	seul | unique	adj.
mawkrra	après (au sens temporel)	conj.
akrrmaw	après ([précédé par la subordonnée])	conj.
Toitslan	Allemagne	prop.n.
Toitsye	Allemand (langue)	adj.
lukpen	nu | sans vêtements	adj.
fmawnta	que | [sbd. au discours rapporté des v.s] stawm [ou] peng | [forme abrégée de:] fmawnit a	n.
vin	demander	vtr.
mìftxele	à ce sujet (dans le sens 'à ce sujet tiens... voyons les arcs Humains maintenant...')	adv.
zìma'uyu	nouvel arrivant (dans le sens 'une personne qui vient juste d'arriver')	n.
nìvingkap	au fait | a propos	adv.
txankrr	depuis longtemps	adv.
vingkap	survenir | venir à l'esprit | frapper (dans le sens [ça m'a frappé])	vtr.
tìomum	connaissance	n.
tinan	lecture	n.
ninan	en lisant	adv.
tsmìm	piste (dans le sens 'la piste d'un animal')	n.
inan	lire | acquérir des connaissances par entrée sensorielle	vtr.
'ä'	oups!	intj.
teynga	cette réponse	n.
teyngla	cette réponse (forme agentive)	n.
teyngta	cette réponse (forme patentive)	n.
fayluta	que | [sbd. rapportant le discours du v.] plltxe ou peng | [forme abrégée de]: faylì'ut a	n.
stxenu	offre | proposition	n.
tìtstew	courage | bravoure	n.
tìtstewnga'	courageux | brave	adj.
stxenutìng	offrir | proposer	vtr.
tsyär	rejeter | repousser | réprouver | éconduire	vtr.
tìtsyär	refus | rejet	n.
mll'an	accepter	vtr.
tìmll'an	acceptation	n.
kam	depuis | il y a	adp.
kay	d'ici ([évènement futur])	adp.
'awnìm	éviter	vtr.
steng	similaire	adj.
nìsteng	similairement	adv.
nim	timide	adj.
srätx	importuner | énerver | gêner	vtr.
säsrätx	contrariété	n.
rì'ìr	reflet | réfelxion	n.
rì'ìr si	refléter | réfléchir | imiter	vin.
tsìsyì	murmurer | chuchotter	vin.
nìwok	bruyemment	adv.
sätsìsyì	murmure | chuchottement	n.
nìtsìsyì	murmurant	adv.
nìfwefwi	en sifflant	adv.
lawr	mélodie	n.
tìng lawr	fredonner	vin.
säomum	indice | renseignement	n.
kosman	énorme | génial | terrible | fantastique	adj.
nìksman	merveilleusement	adv.
letsim	unique | original	adj.
lesngä'i	débuté | commencé | entamé	adj.
nìtsim	avec originalité	adv.
nìsngä'i	à l'origine | originellement | en premier lieu	adv.
ngong	léthargique | manquant d'énergie suffisante | paresseux	adj.
walak	actif | énergique	adj.
tìngong	léthargie | paresse	n.
txi	frénésie | hâte | précipitation	n.
letxi	frénétique	adj.
nìtxi	prestement | frénétiquement	adv.
letxiluke	lent	adj.
nìtxiluke	doucement	adv.
kulat	révéler ([au sens littéraire et métaphysique])	vtr.
txantompa	averse (forte pluie)	n.
meyam	embrasser | (s')étreindre  | serrer dans ses bras	vtr.
sämyam	câlin | embrassade	n.
fìtsap	l'un l'autre | les uns les autres	adv.
nuä+	au-delà	adp.
kanfpìl	concentrer | attirer l'attention	vin.
fmokx	jalousie | envie	n.
nìfmokx	jalousement	adv.
kìmar	saisonnier | opportun	adj.
nìkmar	saisonnièrement | opportunément	adv.
nìngong	paresseusement	adv.
säpom	bisou | baiser	n.
kxukx	avaler | gober	vtr.
txewm	effrayant	adj.
hìmpxì	minorité | petite partie	n.
kawnglan	malicieux | malveillant	adj.
nutx	épais	adj.
flì	mince  | fin	adj.
flìnutx	épaisseur	n.
sneyä	le sien | la sienne | le leur	pn.
säsyep	piège	n.
yora'tu	gagnant | vainqueur	n.
snaytu	perdant	n.
way a plltxe	poème (cérémonial)	ph.
way a rol	récital | poème chanté	ph.
wayä aylì'u	mots ou paroles d'un poème ou chant (cérémonial)	ph.
ultxatu	membre | participant (dans le sens un membre | participant a une rencontre)	n.
wo	atteindre	vtr.
yawo	décoller	vin.
tsìk	soudainement | sans prévenir	adv.
kllwo	descendre | se poser (l'action)	vin.
kllpä	atterrir | atteindre le sol	vin.
sätswayon	vol (dans le sens le vol en ikran ou hélico)	n.
rawn	remplacer | substituer	vtr.
tìrawn	remplacement (l'acte du remplacement dans le sens 'il a effectué un remplacement')	n.
särawn	remplacement | substitution | quelque chose remplaçant une autre	n.
kxeltek	lever | soulever	vtr.
fngo'	exiger	vtr.
säfngo'	exigence	n.
ngam	écho	n.
slär	grotte | caverne	n.
ngampam	rime	n.
ngampam si	rimer	vin.
faoi	lisse	adj.
ekxtxu	rugueux | rude | rèche	adj.
yo'	être parfait | être sans défaut	vin.
nìyo'	parfaitement | avec perfection	adv.
nìyol	brièvement (pour une action temporelle)	adv.
tìyo'	perfection	n.
'ipu	drôle | humoristique | amusant	adj.
tì'ipu	humour	n.
tìfmi	essai | tentative	n.
sä'ipu	quelque chose d'humoristique/de drôle	n.
hangvur	blague | plaisanterie	n.
lì'uvan	jeu de mot | calembour	n.
kanom	acquérir | recevoir | (différent du v. 'avoir')	vtr.
säkanom	acquisition	n.
srìn	transférer (dans le sens 'transférer un élément d'une chose a une autre')	vtr.
käsrìn	prêter	vtr.
zasrìn	emprunter	vtr.
säsrìn	emprunt (dans le sens 'une chose empruntée')	n.
pxìmun'i	diviser	vtr.
lätxayn	conquérir	vtr.
sälätxayn	défaite | une circonstance de défaite	n.
yll	communal | communautaire	adj.
nìyll	communallement (attention ce n'est pas l'adv communément)	adv.
hona	mignon | adorable | charmant	adj.
tìhona	charme	n.
fäkä	monter	vin.
fäza'u	monter	vin.
kllza'u	descendre	vin.
sämok	suggestion	n.
mal	loyal | honnête	adj.
nìmal	avec confiance | sans hésitation	adv.
tìmal	loyauté | honnêteté	n.
kllyem	enterrer	vtr.
nìtsyìl	grimpant	adv.
sätsyìl	ascension | montée	n.
rìn	bois	n.
flawkx	cuir	n.
'ana	vigne grimpante	n.
tsngawpay	larme	n.
tsngawpayvi	petite larme	n.
nìhona	adorablement	adv.
lepay	aqueux	adj.
'ul	augmenter | ([utilisé pour former 'plus..., plus...'])	vin.
nän	réduire | diminuer	vin.
nìnän	moins	adv.
nì'ul'ul	de plus en plus	adv.
nìnänän	de moins en moins	adv.
mek	vide	adj.
leioae	respect	n.
leioae si	respecter	vin.
säwìntxu	exposition (dans le sens 'il y a une exposition au musée')	n.
tì'i'a	fin | conclusion	n.
srer	apparaître | matérialiser	vin.
'ìp	disparaître	vin.
tsong	vallée	n.
tsongtsyìp	cavité | fossette	n.
ro'a	être impressionnant | inspirer la crainte ou le respect	vin.
säro'a	exploit | prouesse	n.
säro'a si	accomplir un exploit | prouesse	vin.
txanro'a	être très impressionnant	vin.
velek	capituler | abdiquer | se rendre | abandonner	vin.
spono	île	n.
txew	bord | limite | frontière | fin	n.
txewnga'	limité (dans le sens 'avoir une limite')	adj.
litx	effilé | tranchant	adj.
fwem	émoussé	adj.
syura	énergie (physique ou spirituelle)	n.
syuratan	bioluminescence	n.
txonkrr	nuitamment | de nuit	adv.
yuey	beauté intérieure	adj.
kxem	être vertical	vin.
txay	être horizontal | à plat	vin.
nìkxem	verticalement	adv.
nìtxay	horizontalement	adv.
klltxay	reposer (sur le sol) | être en position horizontale	vin.
klltxeykay	poser (quelque chose sur le sol)	vtr.
yo	surface	n.
kxemyo	mur | surface verticale	n.
fyep	tenir	vtr.
nìk'ärìp	sans mouvement | immobile	adv.
nìklonu	fidèlement	adv.
nìktungzup	attentivement	adv.
nìsyep	fermement	adv.
nìmeyp	faiblement	adv.
säfyep	poignée | hampe	n.
slan	soutenir (qqn) ([au sens émotionnel, social ou personnel])	vtr.
tìslan	soutien ([émotionnel, social ou personnel])	n.
tìeyktan	leadership	n.
'llngo	hanche	n.
zare'	front	n.
flawm	joue	n.
prrku	utérus	n.
ngep	nombril	n.
tawsyuratan	aurore	n.
syeha	respiration | souffle	n.
syeha si	respirer | souffler	vin.
sko+	en tant que	adp.
sna'o	groupe | ensemble	n.
snatxärem	squelette | groupe d'os	n.
snafpìlfya	philosophie	n.
snatanhì	constellation	n.
sästarsìm	collection	n.
tsu'o	capacité | faculté	n.
krra	quand | au moment où	conj.
snatanhìtsyìp	amas stellaire | groupe d'étoiles	n.
pìwopxtsyìp	nébuleuse	n.
tìterkup	mort ([dans le sens général et abstrait])	n.
maweypeyyu	quelqu'un de calme | patient	n.
ftxulì'u	discourir	vin.
ftxulì'uyu	orateur	n.
säftxulì'u	discours | speech	n.
tìftxulì'u	discours public	n.
slantire	inspiration | suggestion | intuition	n.
slantire si	inspirer | suggérer	vin.
kum	résultat	n.
kuma	que | si bien que (en résultat)	conj.
akum	que (par conséquent) ([suit le résultat])	conj.
fyel	consolider	vtr.
zey	spécial	adj.
vll	pointer | désigner | indiquer	vtr.
eykyu	leader (meneur) | [n'est pas le leader d'un clan mais d'un groupe plus petit comme un groupe de chasse. Ce peut être aussi le leader temporaire d'un plus grand groupe]	n.
am'ake	sûr	adj.
nam'ake	avec confiance | assurance	adv.
kezemplltxe	bien sûr | cela va de soi | cela va sans dire	adv.
tare	avoir une relation avec	vtr.
nìsoaia	comme une famille | familialement	adv.
nìolo'	comme un clan | claniquement	adv.
sätare	relation | rapport	n.
sloa	large	adj.
snep	étroit	adj.
slosnep	largeur	n.
peslosnep	quelle largeur?	inter.
slosneppe	quelle largeur?	inter.
hoet	vaste | immense	adj.
nìhoet	partout	adv.
so'ha	être enthousiasmé	vtr.
tìso'ha	enthousiasme	n.
nìso'ha	avec enthousiasme | enthousiasmant	adv.
leso'ha	enthousiaste | passionné	adj.
tsawlultxa	conférence	n.
zìsìtay	l'année prochaine	n.
tìtsunslu	possibilité	n.
numultxa	classe (dans le sens 'un lieu de rencontre pour apprendre') | cours	n.
numultxatu	camarade de classe	n.
snanumultxa	collège	n.
tìflä	succès | réussite (dans le sens général)	n.
säflä	succès (dans le sens 'le moment du succès')	n.
mesrram	il y a deux jours	adv., n.
mesrray	dans deux jours	adv., n.
pxesrram	il y a trois jours	adv., n.
pxesrray	dans trois jours	adv., n.
mong	compter sur	vtr.
sru'	piétiner | écraser	vtr.
'ekxin	tendu	adj.
um	lâche | déserré | volant	adj.
'ekxinum	étreinte	n.
pekxinum	serré à quel point? relâché à quel point?	inter.
zeswa	herbe	n.
zeswavi	carré d'herbe	n.
lezeswa	herbeux | verdoyant	adj.
lopx	paniquer	vin.
hifwo	s'enfuir | prendre la fuite	vin.
yrrap	orage	n.
'rrpxom	tonnerre	n.
rawm	foudre	n.
rawmpxom	foudre et tonnerre	n.
se'ayl	chute d'eau fine et longue (comptable)	n.
kxor	mur d'eau	n.
syanan	série de chutes d'eau séparées par des piscines naturelles (comptable)	n.
rurur	torrent circulant parmi des roches en pente douce (non comptable)	n.
tseltsul	rapides (comptable mais en de rares occasions)	n.
tìmeyp	faiblesse	n.
am'aluke	sûrement | sans doute	adv.
atanzaw	éclair	n.
nìsìlpey	J'espère que	adv.
talun	parce que | ([forme abrégée de] taluna)	adp.
nìTsyungwen	en chinois	adv.
reykol	jouer de la musique | jouer d'un instrument | ([poétique])	vtr.
nrra	fierté	n.
lenrra	fier	adj.
nìnrra	fièrement | avec fièreté	adv.
snonrra	prétention | vanité	n.
lesnonrra	vaniteux	adj.
nrr	luire | briller	vin.
ylltxep	feu communal	n.
txeptseng	foyer | feu de camp | lieu où un feu brûle ou a brûlé	n.
ralnga'	sensé | significatif	adj.
munsna	paire	n.
fyin	simple	adj.
ep'ang	complexe	adj.
epxang	jarre de pierre  | ([servant pour le stockage du scorpion utilisé lors de l'Uniltaron])	n.
fyinep'ang	degré de complexité	n.
pefyinep'ang	à quel point complexe?	inter.
fyinep'angpe	à quel point complexe?	inter.
sngä'itseng	départ | point de départ | début (au sens géographique)	n.
srungsiyu	assistant (désigne une personne qui aide)	n.
srungtsyìp	truc | conseil | indice	n.
spulmokri	téléphone | interphone | radio	n.
syeprel	appareil photo | caméra	n.
swoa	brevage enivrant | grisant (spiritueux)	n.
rou	être saoul | bourré | beurré comme une tartine | rond comme une queue d'pelle	vin.
pamrelvi	lettre	n.
snapamrelvi	alphabet	n.
tìtxen si	se réveiller | s'éveiller	vin.
fnetxum	allergène	n.
zet	traiter | avoir une attitude envers	vtr.
ha'	convenir | aller | compléter	vin.
syon	aspect | point | caractéristique | attribut | point | aspect | facette | propriété	n.
ran	constitution | essence | nature | personnalité	n.
fyole	sublime	adj.
loran	élégance | grâce	n.
fe'ran	imperfection	n.
reyfya	culture | manière de vivre	n.
fe'ranvi	défaut	n.
nìran	fondamentalement | basiquement	adv.
mo	place	n.
snomo	espace privé | [également]: pièce	n.
wum	approximativement | à peu près	adv.
kesran	médiocre	adj.
nìksran	médiocrement	adv.
yewla	déception (utilisée dans le registre sentimental)	n.
leyewla	décevant	adj.
nìyewla	avec déception | d'une maniére décevante	adv.
yawnyewla	état d'avoir le coeur brisé | d'être désespéré, détruit	n.
ve'o	ordre | organisation	n.
vezo	être organisé | être ordonné	vin.
vezeyko	organiser | ordonner | ([causatif de] vezo)	vtr.
vefya	système | procédure | procédé | approche	n.
velke	cahotique | désordonné | désorganisé	adj.
venga'	organisé | ordonné	adj.
nìfnu	silencieusement | en silence	adv.
sätaron	chasse	n.
wäsul	concourir | participer à une compétition	vin.
tìwäsul	compétition	n.
säwäsul	compétition	n.
säwäsultsyìp	concours	n.
tìmwiä	équité | justice	n.
snew	serrer | reserrer	vtr.
txantxew	maximum	n.
snewsye	sinistre | étrange | bizarre	adj.
hìmtxew	minimum	n.
txantxewvay	d'une manière maximale	adv.
hìmtxewvay	minimalement	adv.
hefi	sentir (odorat)	vtr.
ewku	goûter (à)	vtr.
zìm	sentir | toucher	vtr.
yune	écouter	vtr.
syam	sentir (l'odeur)	vtr.
'ur	vue | apparence	n.
sur	goût | saveur	n.
zir	touche | texture	n.
tse'atswo	sens de la vue	n.
stawmtswo	sens de l'ouïe	n.
hefitswo	sens de l'odorat	n.
ewktswo	sens du goût	n.
zìmtswo	sens du toucher	n.
fkan	sembler | apparaître aux sens comme	vin.
onlor	[ayant une bonne odeur]	adj.
onvä'	puant	adj.
we'ay	sur | aigre | (goût et senteur)	adj.
wip	salé | (goût et senteur)	adj.
fwang	savoureux  | [umami] | riche | (senteur et goût)	adj.
nget	([senteur de bois et de feuilles en décomposition])	adj.
kxänäng	pourissant | putride | ([senteur d'un animal ou de chair en décomposition])	adj.
sosul	([odeur plaisante de l'eau, de la pluie et de la végétation humide environnants])	adj.
unyor	fleuri, boisé (en parlant d'une odeur) | (peut également référer à certaines épices utilisés dans la cuisine Na'vi)	adj.
atxar	([odeur d'animaux vivants que l'on peut trouver autour d'un trou d'eau ou d'un nid])	adj.
inanfya	sens (moyen de perception)	n.
uvan letokx	jeu physique ou athlétique | sport	n.
ftärpa	côté gauche	n.
skiempa	côté droit	n.
rengop	concevoir (pour les détails plus fins)	vtr.
tìrengop	[action ou art de concevoir]	n.
särengop	design	n.
ingyen	sentiment de mystère, d'incompréhension	n.
sngumtsim	chose inquétiante | source d'inquiétude	n.
yayayrtsim	quelque chose de flou | source de confusion	n.
ingyentsim	mystère | puzzle | énigme	n.
ingyentsyìp	truc | méthodologie spéciale | méthodologie rusée	n.
ningyen	mystérieusement	adv.
ingyenga'	mystérieux | énigmatique	adj.
sngunga'	inquiétant | troublant	adj.
yayayrnga'	déroutant | flou | apportant de la confusion	adj.
yrr	sauvage | naturel | [quelque chose dans son état d'origine, pas modifié ni altéré]	adj.
nìyrr	naturellement | sans changer la nature de qqch	adv.
zäfi	modifié | altéré | plus dans un état naturel	adj.
syor	relaxer | se détendre	vin.
tìsyor	détente | relaxation	n.
tìfnunga'	silencieux	adj.
späpeng	se restorer (métaphoriquement)	vin.
'anla	désirer ardemment	vtr.
sä'anla	aspiration (dans le sens 'il à comme aspiration de devenir le prochain Olo'eyktan')	n.
lie	expérience	n.
tsìlpey	espoir (idée abstraite)	n.
säsìlpey	espoir (circonstance particulière)	n.
kelsar	inutile | en vain	adj.
yì	niveau | étape | étage	n.
snayì	escalier | séries de niveaux ascendants	n.
kxaylyì	niveau avancé | ([pour une langue ou toute aptitude])	n.
kxamyì	niveau intermédiaire | ([pour une langue ou toute aptitude])	n.
tìmyì	niveau de base | (pour une langue ou toute aptitude)	n.
flrr	délicat | doux | tendre	adj.
nìflrr	doucement | tendrement | délicatement	adv.
tìflrr	tendresse | délicatesse | douceur	n.
ngä'än	souffrir ([mentalement ou émotionellement]) | être misérable	vin.
kelkin	non-nécessaire | superflu	adj.
nìkelkin	[non-nécessairement]	adv.
sängä'än	déprime, dépression	n.
'eylanay	connaissance ([qui pourrait devenir un ami])	n.
eyktanay	adjoint | général | (un rang en-dessous du chef)	n.
tsulfätunay	(quelqu'un qui est à une étape de devenir un maître/expert)	n.
karyunay	apprenti enseignant/professeur | ([quelqu'un qui est à une étape de devenir enseignant])	n.
tsan'ul	(s')améliorer	vin.
fe'ul	empirer | se détériorer	vin.
tìtsan'ul	amélioration (sens général ou abstrait)	n.
tìfe'ul	aggravation (sens général ou abstrait)	n.
sätsan'ul	amélioration (circonstance spécifique)	n.
säfe'ul	aggravation	n.
frafya	dans toutes les façons	adv.
postì	post/message/billet d'un forum ou d'un blogue	n.
ketsran	peu importe | (n'importe) quoi/quand/où (que ce soit)	adj., conj.
kangay si	confirmer | valider	vin.
txurtel	corde	n.
ropx	trou ([qui traverse un objet])	n.
tsongropx	trou | cavité	n.
tsrul	nid | [zone protégée servant comme maison pour la faune de Pandora]	n.
yayotsrul	nid d'oiseau	n.
lini	petit ([pour un animal, un insecte, un poisson ou un oiseau])	n.
tarnioang	animal prédateur	n.
rong	tunnel	n.
swek	poteau | [longue tige placée à l'horizontal]	n.
mektseng	trou | ouverture	n.
tsenga	où | une place où	conj.
fta	nœud	n.
fta si	nouer | faire un nœud	vin.
fwi	glisser	vin.
oìsss si	siffler | feuler	vin.
il	courber	vin.
kxakx	briser | casser en deux	vin.
ftumfa	en dehors de | hors de	adp.
sä'eoio	cérémonie | rituel | rite	n.
sä'eoio si	participer à une cérémonie | accomplir un rituel	vin.
kur	pendre (de) | être accroché (à)	vin.
nìtkan	exprès | délibérément	adv.
nìtkanluke	accidentellement | involontairement	adv.
nui	échouer | défaillir | [ne pas obtenir le résultat désiré ou attendu] | rater | faire quelque chose de mal | [utilisé pour blâmer]	vin.
nìnu	infructueusement | en vain	adv.
tìnui	échec (concept abstrait)	n.
sänui	échec (circonstance particulière d'échec)	n.
fngä'	se soulager | [sur Terre]: aller au petit coin, à la (aux) toilette(s), au WC.	vin.
zun	si ([conditionnel])	conj.
zel	donc ([dans une phrase au conditionel avec] zun)	adv.
'ekxinumpe	serré à quel point? relâché à quel point?	inter.
okup	lait	n.
loi	œuf	n.
tsyeym	trésor | chose rare ayant une grand valeur	n.
wokau	sorte de tambour	n.
srä	linge ([pièce de linge tissé sur un outil])	n.
srok	perle (objet décoratif)	n.
pxayopin	coloré | multicolore	adj.
tsyoklìt	chocolat	n.
paynäpll	ananas	n.
pamrelsiyu	écrivain | auteur	n.
rel arusikx	film | vidéo	n.
lì'upuk	dictionnaire	n.
nìkemweypey	impatiemment	adv.
kelemweypey	impatient	adj.
'on	forme	n.
salewfya	direction	n.
koum	courbe	adj.
ko'on	anneau | ovale | forme fermée (à peu près circulaire)	n.
yo'ko	cercle | [un anneau parfaitement circulaire]	n.
renulke	irrégulier | imprévisible	adj.
vawt	solide	adj.
momek	pas solide	adj.
yeyfya	ligne droite	n.
yak	branche | point de divergence	n.
yak si	diverger | changer de direction	vin.
nìyeyfya	en ligne droite	adv.
nìftär	à gauche	adv.
nìskien	à droite	adv.
'oratsyìp	étang | mare	n.
nìyawr	correctement	adv.
tìsteftxaw	examination | vérification	n.
yoa	en échange de	adp.
txolar	dollar (monnaie)	n.
ewro	Euro (monnaie)	n.
lawnol	grande joie	n.
ley	avoir une valeur | valoir quelque chose | valoir la peine	vin.
säfmi	essai	n.
nìfkeytongay	en réalité | en fait	adv.
mowar	conseil	n.
mowar si	conseiller | donner un conseil	vin.
mowarsiyu	conseiller (quelqu'un qui conseille)	n.
kakpam	sourd	adj.
tìkakpam	surdité	n.
pxek	botter	vtr.
kolan	Je voulais dire... | Plutôt | ([utilisé pour se corriger])	intj.
hena	porter | emporter | apporter	vtr.
sähena	contenant | récipient	n.
paysena	contenant/récipient d'eau	n.
tutsena	civière	n.
tstalsena	gaine d'un couteau	n.
swizawsena	carquois | (souvent abbrégé pour [zawsena])	n.
tìkakrel	cécité ([aveugle])	n.
ngoa	boue	n.
mawfwa	après ([suivi de la subordonnée])	conj.
neni	sable	n.
fwep	poussière (sur la surface)	n.
fwopx	poussière (dans l'air)	n.
nìyey	directement | justement | droit au but	adv.
'al	gaspiller	vtr.
tì'al	gaspillage	n.
le'al	gaspilleur ([pas pour décrire une personne])	adj.
nì'al	d'une manière gaspilleuse	adv.
srey	version	n.
lupra	style	n.
fyolup	exquis | sublime en style	adj.
fe'lup	mauvais (goût)	adj.
snolup	style personnel | présence	n.
'ongop	dessiner | concevoir	vtr.
'ongopyu	concepteur	n.
uniltìrantokxolo'	clan d'avatars | groupe d'avatars | la communauté d'Avatar	n.
krrka	durant	adp.
tìreyn	train	n.
LosÄntsyelesì	Los Angeles	prop.n.
tson	obligation | devoir | tâche	n.
nìtson	obligatoirement	adv.
kxìm	commander | ordonner | assigner une tâche	vtr.
tsonta	à (utilisé avec [kxìm]) | forme abrégée de: [tsonit a]	conj.
tìkxìm	commandement | ordre	n.
tìkxìm si	être au-dessus de qqn dans une hiérarchie | être le supérieur de qqn	vin.
kxìmyu	commandant | supérieur | quelqu'un ayant une autorité sur une autre personne	n.
saylahe	et cetera | etc. | [abbréviation]: sl.	adv.
fpomron	santé mentale | bien être mental	n.
lefpomron	en bonne santé (mentale)	adj.
kelfpomron	en mauvaise santé (mentale)	adj.
fpomtokxnga'	bon pour la santé (physique)	adj.
kefpomtokxnga'	mauvais pour la santé (physique)	adj.
fpomronga'	bon pour la santé (mentale)	adj.
kefpomronga'	mauvais pour la santé (mentale)	adj.
srefpìl	présumer | supposer | ([vin. et transitif]) | ([s'il est intransitif, on utilise] tsnì)	vtr.
srefwa	avant	conj.
ken'aw	non seulement ([utilisé avec]: släkop)	adv.
släkop	mais également/aussi ([utilisé avec]: ken'aw)	adv.
sngum si	s'inquiéter	vin.
väpam	bruit ([son déplaisant]) | cri strident	n.
hawmpam	bruit ([son excessif, non-nécessaire, inapproprié, inattendu ou alarmant])	n.
lehawmpam	bruyant	adj.
nìhawmpam	bruyamment	adv.
miklor	[plaisant aux oreilles]	adj.
mikvä'	déplaisant aux oreilles	adj.
narlor	visuellement beau	adj.
narvä'	laid | déplaisant aux yeux	adj.
zawr	cri d'un animal	n.
tìnew	désir	n.
nopx	ranger | stocker | conserver	vtr.
tiam	compter	vtr.
ketsuktiam	infini | innombrable | ([pour les noms nombrables])	adj.
txewluke	infini | sans limites | ([pour les noms innombrables])	adj.
'umtsa	remède | médicament	n.
lang	examiner | explorer	vtr.
tìlang	exploration ([sens général])	n.
sälang	exploration | examination	n.
kxum	visqueux | gélatineux | épais	adj.
kxumpay	gel | liquide visqueux	n.
sängop	création ([de quelqu'un])	n.
tsyìl	gravir | escalader	vtr.
kxap	menace	n.
kxapnga'	menaçant | ([pour des personnes et des animaux: a kxap si])	adj.
nìkxap	d'une manière menaçante	adv.
tìftiatu	chercheur | [forme abrégée de:] tìftiatu kifkeyä	n.
tìftiatu kifkeyä	scientifique	n.
heyr	poitrine	n.
tseri	noter | remarquer	vtr.
kxap si	menacer	vin.
tìtseri	conscience | attention	n.
tìktseri	inconscience | manque d'attention	n.
yäkx	ne pas tenir compte | ne pas remarquer | snober	vtr.
tìyäkx	manque d'attention	n.
srunga'	utile | aidant | ([pour décrire une personne: a srung si])	adj.
säyäkx	[action de snober]	n.
ngip	espace | aire ouverte	n.
txepram	volcan	n.
txekxumpay	magma | lave	n.
wrrza'u	sortir | émerger	vin.
tskxevi	galet	n.
nìkx	gravier	n.
tìralpeng	traduction | interprétation	n.
unil si	rêver	vin.
uniltsa	rêver (de/que)	vtr.
mauti	fruit	n.
utu	canopée forestière	n.
utumauti	banane	n.
slayk	brosser | peigner | coiffer	vtr.
tìkelu	manque | insuffisance | pénurie	n.
tompakel	sécheresse	n.
syuvekel	famine	n.
zawprrte'	être plaisant/agréable ([utilisé avec] ne)	vin.
nawri	talentueux	adj.
tìnawri	talent	n.
susyang	fragile | délicat	adj.
reym	terre ferme | ([réfère particulièrement à la terre sèche et se distingue de l'étendue d'eau])	n.
kop	aussi | également | de plus | ([extension de l'information déjà donnée])	conj.
tuvom	le meilleur de tous | extrêmement bon	adj.
yengwal	regret | chagrin	n.
nip	rester pris | être pris	vin.
hän	filet | toile | [aussi:] Internet	n.
'rrko	rouler	vin.
tsngem	muscle	n.
tsawsngem	musclé	adj.
wìngay	prouver	vtr.
tìwìngay	preuve	n.
säwìngay	preuve ([circonstance particulière])	n.
tìng zekwä	sentir | toucher | toucher ([intentionellement])	vin.
weptseng	site internet/web	n.
wep	le Web ([c-à-d le world wide web])	n.
tseotu	artiste ([terme générique])	n.
tìkeftxo	tristesse | peine	n.
tìkeftxonga'	triste ([ne décrit pas une personne])	adj.
pamtseongopyu	compositeur ([de musique])	n.
lereyfya	culturel	adj.
huru	marmite	n.
sey	tasse | bol	n.
'e'in	nacelle | gourde	n.
'e'insey	gourde ([pour boire])	n.
sum	coquillage ([de l'océan])	n.
sumsey	récipient pour boire | ([fait de coquillage])	n.
swoasey	bol de kava | ([fabriqué à partir de gousses, utilisé pour boire des breuvages enivrants])	n.
swoasey ayll	bol de kava communautaire	n.
tsyey	collation | goûter	n.
tsyeytsyìp	petite bouchée	n.
nik	commode | utilisable sans faire beaucoup d'efforts	adj.
niktsyey	emballage alimentaire | ([les aliments sont emballés dans des feuilles et des vignes comestibles])	n.
merki	grille | ([pour les viandes fumées])	n.
ikut	gros pilon ([outil pour broyer]) | bâton pour broyer la viande	n.
sämunge	outil de transport | dispositif de transport | ([objet servant à porter ou transporter qqn/qqch])	n.
syusmung	plateau	n.
paysmung	porteur d'eau	n.
prrsmung	porteur de bébé	n.
nivi	hamac de repos | ([terme générique])	n.
swaynivi	hamac familial	n.
snonivi	hamac simple	n.
sänrr	lueur	n.
tsmi	nectar	n.
tsmisnrr	lanterne | ([fabriquée à l'aide d'une vessie ou du nectar])	n.
seyn	chaise | tabouret | banc | [un outil ou un dispositif pour s'asseoir]	n.
hoan	confort | aise	n.
lehoan	confortable	adj.
nìhoan	confortablement	adv.
kelhoan	inconfortable	adj.
fyan	[dispositif fabriqué pour garder qqch propre et loin du sol]	n.
fyanyo	table | ([fam.:] yo)	n.
yomyo	assiette	n.
yomyo lerìk	assiette feuillue | ([fam.]: rìk)	n.
fyanyì	étagère	n.
kurfyan	grand panier | casier suspendu	n.
snokfyan	casier de rangement personnel	n.
kurfyavi	crochet (pour accrocher ou suspendre qqch)	n.
seyto	abattre | [séparer ou préparer la carcasse d'un animal mort]	vtr.
säseyto	outil de boucherie	n.
yaney	canoë	n.
spulyaney	pagaie	n.
lal	vieux	adj.
txanlal	ancien | très vieux	adj.
tsankum	avantage | bénéfice | gain	n.
tsankumnga'	avantageux | bénéfique	adj.
fekumnga'	désavantageux	adj.
tìmungwrr	exception	n.
tìmungwrr si	faire/permettre une exception/dérogation	vin.
tarpongu	groupe de chasseurs	n.
nawfwe	(un discours) | fluide | fluent | courant	adj.
fekum	désavantage | inconvénient | revers de la médaille	n.
plltxeyu	locuteur	n.
pxawngip	environnement	n.
palulukantsyìp	chat	n.
zum	objet | chose | ([physique et tangible])	n.
hìpey	hésiter | s'arrêter pour penser durant un court moment | ([retarder une action])	vin.
tìhìpey	hésitation	n.
snäm	pourrir | se décomposer | se dégrader | ([objets et connaissances])	vin.
kllrikx	tremblement de terre | séisme	n.
sälatem	modification | changement	n.
tìlatem	changement (concept abstrait)	n.
txatx	bulle	n.
lehìpey	hésitant | incertain | en train d'hésiter	adj.
nìhìpey	avec hésitation	adv.
ronguway	hurler (cri d'un animal)	vin.
ronguwayyu	ce qui hurle	n.
ler	régulier | fluide | ([pour un mouvement])	adj.
nìler	doucement | sans interruption	adv.
lo'a	totem	n.
'ewrang	métier à tisser	n.
sa'ewrang	grand métier à tisser	n.
tiretu	chaman	n.
pasuk	baie | petit fruit	n.
vozampasukut	arbre aux mille baies	n.
paskalin	[terme affectueux] | lit.: baie sucrée	n.
fngä'tseng	toilettes | W.C. | cabinet d'aisance | ([sur Terre])	n.
mo a fngä'	toilettes | W.C. | cabinet d'aisance | ([sur Terre]) | ([espace clos])	n.
sa	relever un défi	vin.
tanleng	écorce d'arbre	n.
syokup	poids ([physique])	n.
kewan	âge ([d'une personne])	n.
tìnvi	tâche | commission | étape ([dans les instructions])	n.
tìnvi si	faire une tâche	vin.
txanwetseng	un lieu aimé ou significatif pour qqn | [heimat]	n.
penghrr	avertir | prévenir	vin.
säpenghrr	avertissement	n.
tì'ul	augmentation	n.
eyawrfya	bonne manière ([de faire qqch.]) | bonne voie	n.
stiwi	bêtise | dégât	n.
stiwi si	être vilain | faire une bêtise	vin.
stiwinga'	malicieux | coquin | espiègle	adj.
stiwisiyu	trouble-fête | personne qui s'amuse à faire des bêtises	n.
rawng	entrée	n.
syewe	gras ([dans la viande])	n.
syewenga'	gras ([en parlant d'un aliment])	adj.
laro si	nettoyer | enlever la poussière	vin.
slukx	corne [(d'un animal)]	n.
tsin	ongle | griffe	n.
ue'	vomir	vtr.
nantangtsyìp	chien ([animal terrien])	n.
hiup	cracher	vtr.
räptum	grossier | vulgaire | inacceptable socialement	adj.
txanlokxe	domaine clanique ou tribal | pays	n.
tsamsä'o	arme de guerre	n.
tìtxurnga'	puissant ([ne qualifie pas une personne])	adj.
leym	crier | interpeller | exclamer	vin.
nìzen	nécessairement	adv.
kenzen	pas nécessairement	adv.
pllhrr	avertir ([synonyme de penghrr])	vin.
säpllhrr	avertissement ([synonyme de säpenghrr])	n.
tspìng	austrapède | ([créature ressemblant à une autruche ou un émeu])	n.
mawup	tortapède | [créature aquatique à six nageoires]	n.
pawk	cor ([instrument à vent])	n.
tekre	crâne	n.
ionar	visière de chevaucheur de banshee	n.
mo'ara	lieu de rassemblement, de réunion ou de rencontre | [également le nom du parc thématique à Walt Disney World]	n.
tìsung	addition | post scriptum (dans le sens 'une chose en plus')	n.
tìng ontu	sentir (odorat)	vin.
tìng ftxì	goûter	vin.
satu'li	héritage | patrimoine	n.
tìkxuke	sécurité | sûreté	n.
emkä	traverser	vtr.
kxu si	faire mal | blesser | endommager	vin.
tswìk	sucer | aspirer	vtr.
tswìk kxenerit	fumer ([une cigarette ou toute autre chose])	vin.
taksyokx	frapper/taper des mains | applaudir	vin.
pamuvan	jeu de son | ([s'amuser avec les sons d'une langue])	n.
kemwiä	impropre | injuste | incorrect | injustifié | inacceptable	adj.
tìkemwiä	injustice	n.
leymkem	protester	vin.
tìleymkem	protestation ([concept abstrait])	n.
säleymkem	protestation | fait de protester	n.
leymfe'	se plaindre	vin.
tìleymfe'	plainte ([concept abstrait])	n.
säleymfe'	plainte	n.
tìleym	appel | cri du coeur	n.
tìtstunwinga'	gentil | aimable | ([comme tstunwi, mais s'applique aux choses])	adj.
tìflänga'	ayant du succès | réussi | réussissant	adj.
ekxan si	exclure | laisser/rester en dehors | bloquer l'accès à qqn	vin.
nìtsleng	faussement | de manière fausse	adv.
kawl	fort | diligemment	adv.
yawntutsyìp	chéri | petit être aimé	n.
weopx	vague (de l'eau)	n.
leweopx	comme une vague	adj.
tsìltsan	bien (concept abstrait) | bonté	n.
lerìn	en bois | (fait) de bois	adj.
letskxe	rocheux | (fait) de roche	adj.
pìsaw	maladroit | enclin à faire des accidents	adj.
tìpsaw	maladresse	n.
txintseng	base des opérations	n.
lanay'ka	frondeur | [Acediacutus xenoterribili]	n.
ilu	ilu | ([grande créature marine ressemblant à un pléiosaure)]	n.
sye'otxang	instrument à vent	n.
vurway	poème narratif | poème racontant une histoire	n.
txopu sleyku	effrayer | faire peur	vtr.
paytxew	rivage | bord de l'eau	n.
lì'ukìng	phrase | ([série de mots])	n.
lì'ukìngvi	locution | syntagme	n.
lì'kong	syllabe	n.
lì'uvi	affixe	n.
eolì'uvi	prefix.	n.
syonlì'u	adj.	n.
fyalì'u	adv.	n.
starlì'u	adp.	n.
tilì'u	conj.	n.
vonvä'	trouduc | imbécile | connard | ([mot très péjoratif et vulgaire])	n.
yo'kofya	cycle	n.
tì'iluke	sans fin | interminable | qui ne finira jamais	adj.
txanso'hayu	fan | partisan | amateur | passionné | [voir so'yu]	n.
'oktrr	jour de commémoration	n.
so'yu	fan | passionné | partisan | amateur | [forme familière de] txanso'hayu	n.
zìsìtsaltrr	anniversaire (annuel) | [voir.:] zìtsaltrr	n.
zìtsaltrr	anniversaire (annuel) | [forme familière de] zìsìtsaltrr	n.
tsukx	poignarder | percer avec un couteau ou tout autre outil	vtr.
ripx	percer | perforer	vtr.
sävll	signe | signalisation | indication | signal	n.
tstxolì'ukìngvi	groupe nominal | ([groupe syntaxique dont le noyau est un nom])	n.
kxì	salut | hé | ([une salutation plus informelle que] kaltxì)	intj.
aho	prier	vin.
tìaho	prière (en général, idée abstraite)	n.
saho	prière	n.
syawn	bénédiction	n.
tìng syawn	bénir	vin.
parul	miracle	n.
parulnga'	miraculeux | miraculé	adj.
parultsyìp	[terme affectif pour les enfants]	n.
keltrrtrr	inhabitual | inusuel | insolite	adj.
txankeltrrtrr	extraordinaire	adj.
nìtxankeltrrtrr	extraordinairement	adv.
hafyon	sagesse	n.
lafyon	sage ([pour une personne])	adj.
hafyonga'	sage (pas pour une personne)	adj.
fkxara	stress ([mental ou émotionnel])	n.
fkxaranga'	stressant	adj.
afpawng	deuil | chagrin	n.
afpawng si	avoir du chagrin	vin.
keyn	poser | déposer	vtr.
palon	brûler	vin.
rem	carburant | combustible	n.
tong	éteindre | étancher	vtr.
reypaytun	rouge | ([rouge sang])	adj.
txeptun	orange | ([rouge feu])	adj.
vultsyìp	bâtcon ([d'un arbre, d'une branche])	n.
'opinvultsyìp	crayon | [abrégé]: pinvul	n.
pinvul	crayon | [forme abrégée de 'opinvultsyìp]	n.
srankehe	plus ou moins | en quelque sorte | oui et non	part., intj.
tì'ongokx	naissance	n.
rìkxi	trembler	vin.
nìrìkxi	en tremblant	adv.
kawkxan	libre | débloqué | débouché	adj.
fnelan	mâle	n.
fnele	femelle	n.
lefnelan	mâle ([qualificatif])	adj.
lefnele	femelle ([qualificatif])	adj.
fwìng	humiliation | embarras | fait de perdre la face	n.
fwìng si	humilier	vin.
fyawìntxuyu	guide ([personne]) | conseiller	n.
han	perdre ([ne pas avoir quelque chose que l'on avait auparavant])	vtr.
tìhan	perte	n.
hipx	contrôler	vtr.
tìhipx	contrôle	n.
snotipx	autodiscipline | autocontrôle | contrôle de soi	n.
kämunge	prendre	vtr.
kawnomum	inconnu / méconnu | ignoré	adj.
le'awtu	seul | tout seul | laissé à lui-même | solitaire | isolé	adj.
lie si	expérience | vécu	vin.
liswa	aliment | alimentation | nourriture	n.
liswa si	nourrir | fournir de la nourriture	vin.
meuia si	honorer	vin.
meyptu	faible | gringalet | ([personne étant faible physiquement ou de caractère])	n.
nafpawng	avec chagrin	adv.
nìt'iluke	pour toujours | à jamais | sans fin | indéfiniment	adv.
nongspe'	poursuivre dans le but de capturer	vtr.
tìsyortsyìp	pause | courte pause | court répit | courte détente	n.
to tìtseri	que ça a l'air | que ce que tu en sais | que tu crois | que tu penses	ph.
tswal	puissance ([physique, psychologique, émotionnelle ou politique])	n.
letswal	puissant | fort	adj.
tswalnga'	puissant	adj.
tswesya	courant ([d'un cours d'eau])	n.
tswesya si	s'écouler ([en parlant d'eau])	vin.
txe'lankong	battement de cœur | battement cardiaque | rythme cardiaque	n.
txurtu	homme fort | femme forte | personne musclée | ([personne au physique ou au caractère fort])	n.
tìtxantslusam	sagesse ([rarement utilisé]) | voir: hafyon	n.
pamrelvul	stylo | crayon | [souvent abrégé]: relvul	n.
relvul	crayon | stylo	n.
pamrelvul lerìn	crayon de plomb	n.
pensìl	crayon | crayon de plomb	n.
'opinsung	colorier | colorer | (lit.: ajouter/mettre de la couleur)	vtr.
uolì’uvi	suffixe	n.
'on si	former | donner forme (à qqch) | ([physiquement ou métaphoriquement])	vin.
kxange	bâiller	vin.
säkxange	bâillement	n.
walew	surmonter | accepter un fait | se réconcilier | se résilier | passer à autre chose	vin.
nìnew	volontairement | de plein gré | de bon gré | par désir	adv.
tawtxew	horizon	n.
frir	couche	n.
lefrir	constitué / fait de couches	adj.
nìfrir	par couches | en couches	adv.
leyr	gelé | congelé	adj.
leyr si	geler | congeler	vin.
lesar si	être utile | être pratique	vin.
leftxozä	De la manière ou faisant partie d'une célébration	adj.
Kelnì	Cologne	prop.n.
Poston	Boston	prop.n.
Nìyu Yorkì	New York	prop.n.
fpxamo	terrible | horrible | affreux | moche	adj.
tìfpxamo	horreur	n.
nìfpxamo	horriblement | terriblement | affreusement	adv.
tsyul	commencer qqch | débuter qqch | amorcer qqch | entamer qqch	vtr.
tìtsyul	début ([neutre quant au temps ou au lieu])	n.
nawang	fusionner | ne faire qu'un avec	vin.
lamaytxa	inondations | puissant captage d'eau	n.
oare	lune	n.
vospxì'aw	janvier	n.
vospxìmun	février	n.
vospxey	mars	n.
vospxìtsìng	avril	n.
vospxìmrr	mai	n.
vospxìpuk	juin	n.
vospxìkin	juillet	n.
vospxìvol	août	n.
vospxìvolaw	septembre	n.
vospxìvomun	octobre	n.
vospxìvopey	novembre	n.
vospxìvosìng	décembre	n.
zìskrrsom	été	n.
zìskrrwew	hiver	n.
paw	grandir | pousser | germiner et se développer (pour une plante)	vin.
tìpaw	croissance | développement	n.
zìskrrmipaw	printemps | (saison des pousses)	n.
tsawn	cueillir de la nourriture de la forêt | (en agriculture) récolter	vtr.
zìskrrtsawn	automne | (saison des récoltes)	n.
'asap	choc soudain	n.
'asap si	être choqué | être surpris	vin.
fe'pey	avoir peur | redouter | craindre | appréhender | s'attendre à ce que quelque chose de mauvais arrive | ([utilisé avec] tsnì)	vin.
ketrìp	malencontreux | peu propice | de mauvaise augure	adj.
txansngum	désespoir | sentiment de grande inquiétude	n.
txansngum si	se sentir désespéré	vin.
tskawr	boîter	vin.
txavä'	dégoûtant	adj.
nìflä	avec succès | avec brio	adv.
txantsawl	géant | immense | énorme	adj.
txasunu	aimer beaucoup | profiter énormément	vin.
zeykoyu	guérisseur | médecin	n.
tìranpam	pas ([son])	n.
ftuopa	par derrière	adp.
fyeng	escarpé | raide | à pic | abrupt	adj.
kavan	supporter ([physiquement])	vtr.
lepxìmrun	commun | fréquemment trouvable	adj.
kelpxìmrun	rare	adj.
zung	s'accroupir | se recroqueviller	vin.
fpivìl	hmm... | laisse-moi réfléchir...	intj.
kom	oser	vim.
mam	emballer | enrouler	vtr.
yomvey	se nourrir de chair | être carnivore	vin.
yomzeswa	paître	vin.
txap	presser | appuyer sur | appliquer une pression sur	vtr.
tìtxap	pression ([physique seulement])	n.
semkä	pont	n.
emkäfya	gué | traverse	n.
fil	jouet pour enfants | joujou	n.
sunkesun	que cela te plaise ou non | que cela vous plaise ou non | que cela plaise ou non	adv.
maitan	mon fils | fiston	ph.
maite	ma fille	ph.
loho	être surpris	vin.
tìloho	surprise	n.
nìloho	étonnamment	adv.
Tsawkenay	Alpha du Centaure B	n.
Tawsnrrtsyìp	Proxima du Centaure | Alpha du Centaure C | ([souvent abrégé en] Snrrtsyìp)	n.
Snrrtsyìp	Proxima du Centaure | Alpha du Centaure C | ([abréviation de] Tawsnrrtsyìp)	n.
kuru	queue neurale	n.
nìtxukx	profondément	adv.
raw	jusqu'à ([en descendant])	adp.
kantseng	destination	n.
la'a	séparation physique | distance entre deux endroits ou deux objets	n.
pela'a	à quelle distance?	inter.
la'ape	à quelle distance?	inter.
pelìmsim	à quelle distance?	inter.
lìmsimpe	à quelle distance?	inter.
keynven	marcher ([en insistant sur le pas]) | faire un pas	vin.
ralke	dépourvu de sens	adj.
tìfkeytongay	réalité	n.
lefkeytongay	réel	adj.
säsrese'a	prédiction	n.
fyìpmaut	arbre à fruit-pieuvre | [octocrus folliculus]	n.
fyìp	vrille | tentacule	n.
koaktutral	chardon de goblin | [cobalus carduus]	n.
lanutral	pissentigre | dandetiger | [candea inflata]	n.
lan	résine	n.
paysyul	lis aquatique | [inrigo lilliam]	n.
rumaut	arbre à fruit boule de canon | [ecdurus putamen pomus]	n.
tsawksyul	lis tournesol | [stella lilliam]	n.
tumpasuk	[pampinus bacca acinum]	n.
fyuatx	anémonoïde	n.
lortsyal	shimmyfly	n.
nalutsa	Nalutsa | ([créature marine pandorienne ressemblant à une baleine])	n.
skuka	Sagittaria | [créature aquatique ressemblant à un céphalopode avec une coquille dure et de longues tentacules]	n.
srakat	dinicthoïde | ([créature aquatique ressemblant à un piranha qui vit dans les lacs et les drainages sombres des basses terres])	n.
tsiki	tique des récifs	n.
teylupil	face de [teylu] | ([insulte])	n.
kalweyaveng	fils de pute | [lit.]: 'enfant d'une araignée venimeuse' | ([insulte])	n.
txanfwìngtu	bâtard | [loser] | raté | ([insulte])	n.
kurkung	trou du cul | connard | ([insulte puissante, vulgaire])	n.
kung	putride | pourri | fétide	adj.
stä'nìpam	enregistrement ([audio])	n.
stä'nìpam si	enregistrer | faire un enregistrement ([audio])	vin.
pxoe	nous trois ([exclusif, excluant toi])	pn.
lìktap	tordu, courbé	adj.
ventil	cheville	n.
hupx	manquer/rater (sa cible), ne pas atteindre sa cible	vtr.
tsawtsray	ville de taille petite ou moyenne	n.
txantsawtsray	grande ville, métropole	n.
Akwey	homme Na'vi	prop.n.
Amhul	femme Na'vi	prop.n.
Anurai	nom de clan Na'vi	prop.n.
Aonung	homme Na'vi du clan Metkayina	prop.n.
Ateyitan	fils d'Ateyo	prop.n.
Ateyo	homme Na'vi	prop.n.
ayRam aLusìng	Montagnes flottantes Montagnes Hallelujah	prop.n.
ayVitrayä Ramunong	puits des Âmes	prop.n.
Änsìt	homme Na'vi	prop.n.
Entu	homme Na'vi	prop.n.
Eytukan	homme leader du clan Omatikaya	prop.n.
Eywa	esprit mondial, équivalant à Gaïa	prop.n.
Eywa'eveng	Pandora	prop.n.
Iknimaya	rite de passage pour un jeune Na'vi	prop.n.
Ìstaw	homme Na'vi	prop.n.
Kamun	homme Na'vi	prop.n.
Kekunan	nom de clan Na'vi	prop.n.
Kelutral	arbre-maison	prop.n.
Li'ona	nom de clan Na'vi	prop.n.
Lo'ak	deuxième fils de Jake et Neytiri	prop.n.
Lo'akur	amulette du Toruk Makto	prop.n.
Metkayina	clan des gens du récif	prop.n.
Mo'ara	vallée sur Pandora (Note: Également le nom de la section Pandora à Disney)	prop.n.
Mo'at	tsahìk du clan Omatikaya	prop.n.
Mo'at'ite	fille de Mo'at	prop.n.
Naranawm	Polyphemus	prop.n.
Nawmtoruktek	Totem du Toruk Makto	prop.n.
Neteyam	fils aîné de Jake et Neytiri	prop.n.
Newey	femme Na'vi	prop.n.
Neytiri	femme Na'vi du clan Omatikaya	prop.n.
Ninat	chanteuse du clan Omatikaya	prop.n.
Omatikaya	clan de la flûte bleue	prop.n.
Otranyu	homme Na'vi	prop.n.
Peyral	femme Na'vi du clan Omatikaya	prop.n.
Pongu Pongu	« groupe groupe » (utilisation irrégulière; nom du bar à Disney's Pandora - The World of Avatar)	prop.n.
Ralu	homme Na'vi	prop.n.
Rini	femme Na'vi	prop.n.
Ronal	femme Na'vi du clan Metkayina	prop.n.
Rongloa	nom de clan Na'vi	prop.n.
Rotxo	homme Na'vi du clan Metkayina	prop.n.
Satu'li	cantine dans la vallée de Mo'ara	prop.n.
Seze	banshee de Neytiri	prop.n.
Silwanin	sœur de Neytiri	prop.n.
Sorewn	femme Na'vi	prop.n.
Swotulu	rivière sacrée	prop.n.
Swotu Wayä	place sacrée de chant (située dans la vallée de Mo'ara)	prop.n.
Tawkami	nom de clan Na'vi	prop.n.
Tipani	nom de clan Na'vi	prop.n.
Tonowari	homme Na'vi du clan Metkayina	prop.n.
Tsahìk	matriarche, grande prêtresse, interprète	prop.n.
Tsenu	femme Na'vi	prop.n.
Tsireya	femme du clan Metkayina	prop.n.
Tskaha	nom de clan Na'vi	prop.n.
Tsu'tey	homme du clan Omatikaya	prop.n.
Tsumongwi	nom d'origine des Omatikayas	prop.n.
Tuke	femme Na'vi	prop.n.
Tuktirey	fille de Jake et Neytiri	prop.n.
Txärpawk	cor fait d'os de Palulukan	prop.n.
Txewì	homme Na'vi	prop.n.
Txilte	femme Na'vi	prop.n.
Uniltaron	chasse de rêves	prop.n.
Utral Aymokriyä	arbre des voix	prop.n.
Va'ru	homme Na'vi	prop.n.
Vitrautral	arbre des âmes	prop.n.
pemsu	quelles deux personnes?	inter.
mesupe	quelles deux personnes?	inter.
pepsu	quelles trois personnes?	inter.
pxesupe	quelles trois personnes?	inter.
paysu	quelles personnes?	inter.
aysupe	quelles personnes?	inter.
pestan	quel homme?	inter.
tutampe	quel homme?	inter.
pemstan	quels deux hommes?	inter.
mestampe	quels deux hommes?	inter.
pepstan	quels trois hommes?	inter.
pxestampe	quels trois hommes?	inter.
paystan	quels hommes?	inter.
aystampe	quels hommes?	inter.
peste	quelle femme?	inter.
tutepe	quelle femme?	inter.
pemste	quelles deux femmes?	inter.
mestepe	quelles deux femmes?	inter.
pepste	quelles trois femmes?	inter.
pxestepe	quelles trois femmes?	inter.
payste	quelles femmes?	inter.
aystepe	quelles femmes?	inter.
yokx	bouclier, protection	n.
smaw	approuver	vtr.
tìsmaw	approbation	n.
natxu	désapprouver	vtr.
tìnatxu	désapprobation	n.
la'um	prétendre (utilisé avec tsnì)	vin.
tìla'um	prétexte	n.
tsaktap	violence	n.
letsaktap	violent	adj.
tsaktap si	être violent, utiliser la violence	vin.
mungwrrtxo	à moins que, sauf si (habituellement utilisé avec le subjonctif <iv>)	conj.
tìvirä	diffusion, propagation, prolifération	n.
wrrkä	sortir (à l'extérieur)	vin.
txung	déranger, perturber, gêner, affecter négativement	vtr.
palang	contacter (au sens social du terme), communiquer avec	vtr.
tìpalang	contact (social)	n.
tstunkem	faveur, acte de bonté (souvent prononcé tsungkem)	n.
tstunkem si	faire une faveur	vin.
tstunkemtsyìp	petite faveur	n.
säfrìp	morsure	n.
tsawng	(se) briser | briser en plusieurs morceaux	vin.
pon	balancer	vtr.
mei	mouillé, trempé	adj.
meitayo	marécages	n.
lipx	dégoutter, tomber goutte à goutte	vin.
fäpyo	toit	n.
sälipx	goutte (d'un liquide)	n.
kxutslu	risque	n.
lekxutslu	risqué	adj.
fura	que | subordonnée à une proposition d'un verbe qui requiert le datif | forme raccourcie de: fì'ur a	sbd.
tsìpxì	(un) quart	n.
mrrpxì	(un) cinquième	n.
pupxì	(un) sixième	n.
kipxì	(un) septième	n.
vopxì	(un) huitième	n.
sänume si	enseigner, instruire, donner des instructions	vin.
vun	fournir	vtr.
lew säpi	se couvrir	vin.
piak säpi	s'ouvrir, ouvrir par soi-même/de soi-même	vin.
tstu säpi	se fermer, fermer par soi-même/de soi-même	vin.
ioi säpi	se décorer, s'orner, se parer (d'un ornement)	vin.
tsawlapx	arbre unidelta, lit. grande racine large	n.
yìmkxa	attrape-banshee, attache-gueule	n.
äzan	force, contrainte	n.
äzan si	forcer, contraindre	vin.
äzanluke	volontairement, sans force ni contrainte	adv.
äzantu	personne dominante; personne autoritaire, despotique, tyrannique, dictatoriale	n.
nìsok	récemment	adv.
kemuia	déshonneur	n.
kemuia si	déshonorer	vin.
tìfnawe'	lâcheté, faiblesse	n.
kemuianga'	déshonorable	adj.
tìkankxan	obstacles aux objectifs de quelqu'un, source de frustration	n.
tìkankxanga'	frustrant	adj.
lekxan	bloqué, obstrué, frustré	adj.
ftanglen	prévenir, empêcher	vtr.
tìftanglen	prévention	n.
pxawtxap	presser, serrer, étreindre	vtr.
plltxepam	phonème	n.
koren ayll	loi, règle sociétale	n.
leykek	imposer, appliquer	vtr.
horenleykekyu	celui qui applique la loi, policier	n.
leykekyu	celui qui applique la loi, policier (forme abrégée de horenleykekyu)	n.
zevakx	cruel (pour décrire une personne)	adj.
tìzevakx	cruauté	n.
tìzevakxnga'	cruel (pas pour des personnes)	adj.
nìzevakx	cruellement	adv.
fmong	voler (qqch ou qqn)	vtr.
tìfmong	vol (d'objet ou de personne0	n.
fmongyu	voleur	n.
