"Frontside"	"Flipside"	"Category"
'ampi	berühren	vtr.
'angtsìk	Hammerkopf	n.
'aw	eins	num.
'awkx	Klippe, Kliff	n.
'awpo	eine/r (Einzelperson)	pn.
'awsiteng	zusammen, gemeinsam	adv.
'awve	erste/r/s	adj.
'e'al	schlimmste/r/s, schlechteste/r/s	adj.
'eko	attackieren, angreifen	vtr.
'ekong	Schlag (rhythmisch)	n.
'engeng	eben, flach	adj.
'eveng	Kind	n.
'evi	Kind, Kindchen, Kindlein (affectionate form of)	n.
'ewan	jung	adj.
'eylan	Freund (geschlechtslos)	n.
'ì'awn	bleiben, verbleiben, verweilen	vin.
'ìheyu	Spirale, Wendel	n.
'Ìnglìsì	Englisch (Sprache)	n.
'it	Bißchen, Stückchen, kleine Menge	n.
'itan	Sohn	n.
'ite	Tochter	n.
'ok	Andenken, Gedenken, Erinnerung	n.
'ong	erblühen, sich entfalten	v.
'u	Ding (Sache, Tatsache, Abstraktion)	n.
'upe	Was, Welches (Ding)	inter.
'upxare	Nachricht, Mitteilung	n.
a	das/der/die, welche/r/s (Relativpronomen)	part.
alaksi	fertig, bereit	adj.
lìm	weit weg sein, entfernt sein	svin.
apxa	groß, erheblich, umfangreich	adj.
atan	Licht	n.
atokirina'	Samen des Großen Baumes	n.
atxkxe	Land, Boden	n.
au	Trommel (aus Haut/Fell)	n.
aungia	Omen, Zeichen, Vorzeichen	n.
awaiei	Paradiesbanshee	n.
awnga	wir	pn.
ayfo	sie (Plural)	pn.
aynga	ihr (alle)	pn.
ayoe	wir (exklusiv)	pn.
ayoeng	wir (inklusiv)	pn.
äie	Vision, Sehen (spirituell)	n.
äo	unter, darunter	adp.
ätxäle	Bitte, Anfrage	n.
ätxäle si	anfragen, verlangen, höflich ersuchen (mit tsnì Satz für das Objekt)	vin.
ean	blau, grün	adj.
eltu	Gehirn	n.
eltu si	anhören, Aufmerksamkeit schenken, sich kümmern um	vin.
eltungawng	Gehirnwurm	n.
emza'u	bestehen (einen Test), bewältigen, überwinden	vtr.
eo	vor (Ort)	adp.
eyawr	korrekt, richtig, zutreffend, genau	adj.
eyaye	Kriegshaube	n.
eyk	führen, anführen, leiten	vtr.
eyktan	Anführer	n.
fa	mit, mittels, durch	adp.
fahew	Geruch, Gestank	n.
fìfya	so (auf diese Art und Weise)	adv.
fìkem	dies, dieses (diese Aktion)	pn.
fìpo	diese Person oder Sache	pn.
fìtxan	so (sehr), besonders, in solchem Ausmaße	adv.
fìtseng	hier, dieser Ort	adv., n.
fìtsenge	hier, dieser Ort	adv., n.
fì'u	dies, dieses (Ding)	pn.
fkarut	schälen, häuten	v.
fkew	gewaltig, mächtig	adj.
fko	eine/r, man (nichtspezifizierter Handelnder)	pn.
flä	glücken, gelingen, Erfolg haben	vin.
fmawn	Neuigkeit, etwas zu berichten	n.
fmetok	testen, prüfen, überprüfen	vtr.
fmi	versuchen, probieren	vtrm.
fngap	Metall	n.
fngapsutxwll	metallsuchende Pflanze, Anemonide	n.
fnu	beruhigen, ruhig sein, leise sein	vin.
fo	sie (plural)	pn.
fpak	zögern, sich zurückhalten, Tätigkeit unterbrechen/einstellen	v.
fpe'	senden, schicken	vtr.
fpeio	Herausforderung (zeremoniell)	n.
fpi	wegen, zuliebe, um ... willen	adp.
fpìl	denken	vtr.
fpom	Wohlsein, Friede, Glück	n.
fpxafaw	Medusa (Tier)	n.
fpxäkìm	eintreten, betreten	vin.
fra'u	alles (jedes Ding)	pn.
frakrr	immer, jeder Zeit	adv.
frapo	jeder, jede, alle	pn.
frrfen	besuchen	vtr.
frrtu	Gast, Besucher	n.
ftang	stoppen, anhalten, aufhalten	vim.
fte	sodass, um…zu	conj.
fteke	sodass nicht, dass nicht, damit nicht	conj.
ftia	studieren, erforschen, untersuchen	vtr.
ftxì	Zunge	n.
ftxozä	Feier, Fest, fröhlicher Anlass, freudiges Ereignis	n.
ftu	von, ab, aus (Richtung)	adp.
ftue	leicht, einfach	adj.
ftxavang	leidenschaftlich	adj.
ftxey	wählen, aussuchen, auswählen	vtr.
fu	oder	conj.
futa	dass (NebensatzMarker)	pn., sbd.
fwa	dass (NebensatzMarker)	pn., sbd.
fya'o	Pfad, Weg, Verhalten, Art und Weise	n.
fyape	wie?	inter.
fyawìntxu	anleiten, führen, leiten	vin.
ha	so, also, daher, in diesem Fall	adv.
hahaw	schlafen	vin.
hapxì	Teil	n.
hasey	fertig, erledigt, fertiggestellt	adj.
hawnu	schützen, beschützen, wahren	vtr.
hì'i	klein, gering (Größe)	adj.
hiyìk	lustig, seltsam, komisch	adj.
hol	wenig, ein paar, einige	adj.
holpxay	Zahl, Nummer	n.
hrrap	Gefahr	n.
hu	mit, zusammen mit, in Begleitung von	adp.
hufwe	Wind	n.
hum	abreisen, weggehen, verlassen	vin.
i'en	Saiteninstrument	n.
ikran	Banshee	n.
ikranay	Waldbanshee	n.
ioang	Tier, Bestie, Biest	n.
irayo	Danke, Dank	n., intj.
ìlä	folgend, entlang, via; laut	adp.
ka	(quer) über, übergreifend	adp.
kä	gehen	vin.
kali'weya	giftige Spinnenart	n.
kalin	süß (Geschmack)	adj.
kaltxì	Hallo	intj.
kämakto	ausreiten	v.
kame	sehen, verstehen, kennen, erkennen (spirituell)	vtr.
kan	vtrm. zielen, abzielen, beabsichtigen; vtr. zielen, eine Waffe oder anderes Objekt auf ein Ziel richten	vtrm., vtr.
kangay	gültig, stichhaltig, richtig	adj.
kar	lehren, unterrichten	vtr.
karyu	Lehrer	n.
kato	Rhythmus	n.
kawkrr	niemals, nie	adv.
kawng	böse, schlecht, übel	adj.
kawtu	niemand	pn.
ke	nicht	adv.
ke'u	nichts, Nichts	pn.
kehe	nein	part., intj.
kelku	Heim, Heimat, Zuhause, Haus	n.
kelku si	leben, wohnen, hausen	vin.
kem	Ding (Aktion), Tat, Handlung	n.
kempe	Was? (Welche Aktion)	inter.
kenong	darstellen, veranschaulichen, bedeuten, repräsentieren (ii)	vin.
kerusey	tot	adj.
ketuwong	Alien, Außerirdische/r, Fremde/r	n.
kewong	fremd, außerirdisch	adj.
keye'ung	Wahnsinn, Irrsinn	n.
kifkey	Welt (physisch)	n.
kilvan	Fluss	n.
kìm	drehen, wirbeln	vtr.
kin	brauchen, bedürfen, benötigen	vtr.
kinam	Bein	n.
kinamtil	Knie	n.
kìng	Faden, Strang	n.
kip	zwischen, unter, mitten unter, inmitten	adp.
kìte'e	Dienst, Dienstleistung	n.
kllfro'	verantwortlich sein	svin.
kllkulat	aufgraben, ausgraben	vtr.
kllkxem	stehen	vin.
kllpxìltu	Bereich, Gebiet, Land, Territorium	n.
kllte	Boden, Grund	n.
ko	Einverständnis einholen (makto ko!  'Lass uns reiten!')	part.
kop	auch, ebenfalls, zusätzlich	adv.
koren	Regel, Richtlinie	n.
krr	Zeit	n.
krrnekx	dauern, Zeit brauchen (ii)	vin.
krrpe	Wann?	inter.
kunsìp	Hubschrauber (Waffenschiff)	n.
kurakx	verjagen, vertreiben	vtr.
kxam	Mitte, Mittelpunkt	n.
kxamtseng	Zentrum, Mittelpunkt (Ort)	n.
kxangangang	Bumm, Knall (Lautmalerei)	intj.
kxanì	verboten, unerlaubt	adj.
kxawm	vielleicht, eventuell	adv.
kxener	Rauch	n.
kxetse	Schwanz	n.
kxeyey	Fehler, Irrtum	n.
kxll	Ansturm, Angriff	n.
lahe	andere/r/s, weitere/r/s	adj.
lam	scheinen, erscheinen, wirken, aussehen	vin.
lapo	der/die/das andere	pn.
latem	ändern (sich), verändern (sich)	vin.
law	eindeutig, klar, gewiss, sicher	adj.
lefpom	fröhlich, friedlich, erfreulich (nicht für Personen), angenehm	adj.
lertu	Kollege, Mitarbeiter	n.
letrr	täglich	adj.
letsunslu	möglich	adj.
lì'u	Wort	n.
lì'fya	Sprache	n.
lok	nähern, annähern	vtr.
lonu	freilassen, befreien, gehen lassen	vtr.
lor	schön, angenehm für die Sinne	adj.
loreyu	helicoradium spirale, schöne Spirale (Pflanze)	n.
lrrtok	Lächeln	n.
lrrtok si	lächeln	vin.
lu	sein, bin, bist, ist, sind (Kopula, Verb der Existenz)	vin., svin.
lun	Grund, Begründung	n.
lumpe	Warum?	inter.
ma	Oh (Marker für den Vokativ)	part.
makto	reiten	vtr.
mawey	ruhig, gefasst	adj.
mefo	die, diese beiden	pn.
menari	Augen (zwei)	n.
meoauniaea	Harmonie, im Einklang mit der Natur leben	n.
meuia	Ehre	n.
meyp	schwach, kraftlos, empfindlich	adj.
mi	noch, noch immer, wie vorher	adv.
mip	neu	adj.
mikyun	Ohr	n.
mì	in, im, an, auf	adp.
mìn	rotieren (um eine Achse), wenden	vin.
mìso	weg (Position)	adv.
mllte	zustimmen, übereinstimmen	vin.
moe	wir, wir beide (exklusiv)	pn.
mokri	Stimme	n.
muiä	anständig, passend, gerecht, richtig, fair	adj.
mun'i	schneiden	v.
mune	zwei	num.
munge	nehmen, bringen, mitbringen	vtr.
mungwrr	außer, bis auf, abgesehen von	adp.
muntxa	gepaart, vereint	adj.
na	wie, als, so wie	adp.
na'rìng	Wald	n.
Na'vi	Volk (der Na'vi), eingeborenes Volk Pandoras	prop.n.
nang	Ausruf, Überraschung, Zuspruch (mirativ, unerwartete oder neue Information)	part.
nantang	Natterwolf (Viperwolf, Caniferratus costatus)	n.
nari	Auge	n.
nari si	aufpassen, achtgeben	vin.
nawm	grossartig, bedeutend, edel, nobel	adj.
ne	zu, nach, in Richtung	adp.
ne'ìm	zurück (Richtung)	adv.
nekx	verbrennen, verbrauchen	vtr.
neto	weg (Richtung)	adv.
new	wollen, möchten	vtrm.
niä	greifen, fassen, packen	vtr.
nì'aw	nur, ausschließlich, lediglich	adv.
nìawnomum	wie wir wissen, wie bekannt (umgangssprachlich [naw.no.mum])	adv.
nì'awtu	allein (als eine Person)	adv.
nì'awve	zuerst, erst	adv.
nì'it	etwas, ein kleines Bisschen (Abstrakt)	adv.
nì'ul	mehr	adv.
nìayoeng	wie wir, wie wir es tun (umgangssprachlich [naj.wEN])	adv.
nìftue	einfach, leicht	adv.
nìftxavang	leidenschaftlich, von ganzem Herzen	adv.
nìhawng	allzu, zu, übermäßig	adv.
nìltsan	gut	adv.
nìmun	wieder	adv.
nìn	schauen, hinsehen, anschauen	vtr.
nìngay	genau, wirklich, wahrlich	adv.
nìtam	genug	adv.
nìteng	auch, ebenfalls, ebenso	adv.
nìtut	laufend, fortwährend	adv.
nìtxan	sehr, viel (Abstrakt)	adv.
nìwin	schnell, in schneller Weise	adv.
nìwotx	in toto, im Ganzen, ganz	adv.
nulkrr	länger (zeitlich)	adv.
nulnew	vorziehen, bevorzugen, begünstigen (ii)	vtrm.
nume	lernen, Wissen oder Verstehen erlangen	vin.
nga	Du	pn.
ngawng	Wurm	n.
ngay	wahr, echt, richtig, zutreffend	adj.
ngenga	Sie (Höflichkeitsform von Du)	pn.
ngim	lang (physikalisch)	adj.
ngop	erschaffen, erstellen, gestalten, hervorbringen	vtr.
ngrr	Wurzel	n.
nguway	Heulen, Schrei (eines Natterwolfs)	n.
oe	ich	pn.
oeng	wir beide (dual inklusive), Du und Ich	pn.
oeyk	Grund, Ursache, Anlass	n.
ohe	Ich (ehrerbietige oder zeremonielle Form)	pn.
olo'	Stamm, Clan	n.
olo'eyktan	Stammesanführer, Clanführer	n.
omum	wissen, et. kennen	vtr.
ontu	Nase	n.
pähem	ankommen, eintreffen	vin.
pak	Satzpartikel der Verunglimpfung/Herabsetzung	part.
pa'li	Direhorse, Pandorisches Pferd ähnliches Tier	n.
palulukan	Thanator, bestiapanthera ferox	n.
pam	Geräusch, Klang, Ton	n.
pamtseo	Musik	n.
pamtseowll	Katzenohr (Pflanze), Musikpflanze, felinafolia ferruginea	n.
pängkxo	(sich) unterhalten (mit), sprechen, plaudern	vin.
pänutìng	versprechen (jemandem etwas), zusagen (ii)	vtr.
pätsì	Abzeichen, Emblem	n.
pawm	fragen	v.
pay	Wasser, Flüssigkeit	n.
paywll	Wasserpflanze (Aloe Vera ähnlich), Dapophet, aloeparilus succulentus	n.
pe	Interrogativ Marker	affix
pe'un	entscheiden, beschließen	vtr.
pefya	Wie?	inter.
pehem	Was? (welche Aktion?)	inter.
pehrr	Wann? (welche Zeit?)	inter.
pelun	Warum? (welcher Grund?)	inter.
peng	erzählen, berichten, sagen	vtr.
penghrrap	binärer Sonnenschein, gefranste Lampe, lucinaria fibriata	n.
peseng	Wo? (welcher Ort?)	inter.
pesu	Wer? (welcher Person?)	inter.
peu	Was? (welches Ding?)	inter.
pey	warten, abwarten	vin.
pizayu	Vorfahre, Ahne	n.
plltxe	sprechen, reden	v.
po	er, sie	pn.
poan	er (keine Pluralform: verwende (ay)fo)	pn.
poe	sie (sg.) (keine Pluralform: verwende (ay)fo)	pn.
pongu	Gruppe von Leuten	n.
prrnen	Säugling, Baby	n.
prrnesyul	Knospe	n.
prrte'	angenehm, vergnüglich (Aktivität)	adj.
pxan	würdig, angemessen, ehrenwert	adj.
pxasìk	Scheiss drauf!, Vergiss es! (vulgär)	intj.
pxasul	frisch, ansprechend (als Nahrung)	adj.
pxay	viele	adj.
pxey	drei	num.
pxi	spitz (z.B. Nadel)	adj.
pxìm	oft	adv.
pxiut	Rasierklingenpalme, scharfer Baum, saltcellar gracilis	n.
pxorna'	Episoth, explodierender Same, croquembouche columnare	n.
pxun	Arm	n.
pxuntil	Ellbogen	n.
rä'ä	tu nicht, hab nicht (für negative Imperative)	part.
ral	Bedeutung, Sinn	n.
ralpeng	interpretieren, übersetzen, deuten (ii)	vtr.
rawke	Alarmschrei, Verteidigungsruf	intj.
rel	Bild, Darstellung, Abbild	n.
reltseo	darstellende Kunst	n.
reltseotu	Künstler (visuell)	n.
renu	Muster, Schema	n.
rey	leben	vin.
rikx	bewegen, umziehen, Position ändern	vin.
rim	gelb	adj.
rina'	Samen (singular)	n.
riti	Stachelfledermaus, scorpiobattus volansii	n.
rol	singen	v.
ronsem	Verstand, Geist	n.
rum	Ball, Kugel	n.
rumut	Kugelbaum	n.
run	finden, entdecken	vtr.
rutxe	(ich) bitte (dich darum)	intj.
sa'nok	Mutter	n.
sa'nu	Mama (affectionate form of)	n.
san	Zitat (siehe auch sìk)	adv.
sänume	Lehre, Unterrichtung, Unterweisung	n.
säspxin	Krankheit	n.
sempu	Papa (affectionate form of)	n.
sempul	Vater	n.
set	jetzt, nun	adv.
sevin	schön, hübsch (vorrangig für weibliche Personen)	adj.
seyri	Lippe	n.
seze	blaue Blume	n.
si	(Hilfsverb, nachgestelltes nichtgebundenes Verb) tun, machen	
sì	und (connects two things, can be attached as --sÃ¬: for clauses use)	conj.
sìk	Zitat Ende (siehe auch san)	adv.
sìlpey	hoffen (mit tsnì für die erhoffte Sache, außer im unabhängigen Satz) (ii)	vin.
sìlronsem	schlau, intelligent (Sache)	adj.
sìltsan	gut, gut gemacht	adj.
ska'a	zerstören, vernichten	vtr.
skxawng	Trottel, Idiot	n.
slä	aber	conj.
slu	werden (Prädikat mit ne in mehrdeutigen Konstruktionen)	vin.
sngä'i	anfangen, beginnen, starten	vim.
sngä'ikrr	Anfang, Beginn, Startzeit	n.
sngel	Abfall, Müll, Unrat	n.
sngeltseng	Müllhalde, Abfallplatz	n.
snumìna	dumm, einfältig	adj.
som	heiß	adj.
somtìlor	Popsicle, heiße Schönheit (Pflanze), capsulatum virgatum	n.
spaw	glauben	vtr.
spxam	Pilz	n.
spe'e	fangen, einfangen	vtr.
spe'etu	Gefangener	n.
spxin	krank, übel	adj.
srak	kennzeichnet Ja oder Nein Fragen	part.
srake	kennzeichnet Ja oder Nein Fragen	part.
srane	ja	part., intj.
srew	tanzen	vin.
srung	Hilfe, Unterstützung	n.
stawm	hören	vtr.
steftxaw	prüfen, kontrollieren, untersuchen	vtr.
stum	beinahe, fast	adv.
sutx	verfolgen, folgen, im Visier haben	vtr.
swaw	Moment, Augenblick	n.
swey	beste/r/s	adj.
swirä	Kreatur, Geschöpf, Wesen	n.
swizaw	Pfeil	n.
swok	heilig	adj.
swotu	heiliger Ort	n.
syaw	rufen	vin.
syulang	Blume	n.
ta	von, ab, aus (lokal), seit (zeitlich mit anderen Zeitwörtern)	adp.
ta'em	von oben	adv.
tafral	daher, deshalb	adv.
täftxu	weben, flechten	vtr.
täftxuyu	Weber, Flechter	n.
takuk	schlagen, treffen	vtr.
talioang	Sturmbestie (sturmbeest), bovindicum monocerii	n.
talun	weil, denn, vom Beweggrund ausgehend	conj.
taluna	weil, denn, vom Beweggrund ausgehend	conj.
tam	ausreichen, genügen, reichen; Okay, in Ordnung	vin., intj.
tam tam	ruhig, beruhig dich, gut gut	intj.
tangek	Stamm (eines Baumes)	n.
tanhì	Stern, biolumineszentes Fleckchen/Punkt	n.
taron	jagen	vtr.
taronyu	Jäger	n.
tautral	Himmelsbaum	n.
taw	Himmel	n.
taweyk	weil, aufgrund der Ursache	conj.
taweyka	weil, aufgrund der Ursache	conj.
tawsìp	Himmelsschiff	n.
tawng	untertauchen, sich ducken, tauchen	vin.
tawtsngal	Panopyra, Himmelsbecher, panopyra aerii	n.
Tawtute	Himmelsperson, Mensch	prop.n.
te	verwendet in Eigennamen	part.
tel	empfangen, erhalten	vtr.
telem	Schnur, Seil, Leine, Strick	n.
teng	selbe, gleiche, gleichwertig	adj.
tengfya	wie, als, genauso wie, auf die gleiche Art wie (situationsbezogene Ähnlichkeit)	conj.
tengkrr	während, solange, wie (zur gleichen Zeit wie)	conj.
teri	über, betreffend, bezüglich, hinsichtlich	adp.
terkup	sterben, umkommen	vin.
teswotìng	gewähren, zugestehen, gestatten, genehmigen (ii)	vtr.
teya	voll, gefüllt, satt, ganz	adj.
teylu	Käferlarve	n.
tewti	Wow, Hey, Ausruf von Überraschung und Freude	intj.
til	Gelenk, Verbindungsstelle	n.
tirea	Geist, Seele	n.
tireafya'o	Spirit Path, Geistes Weg	n.
tireaioang	Spirit Animal, Geistes Tier, Seelentier	n.
tireapängkxo	kommunizieren (nicht verbal)	v.
tì'eyng	Antwort, Erwiderung	n.
tìfmetok	Test, Prüfung	n.
tìftang	Stoppen, Aufhören; Glottisstop, plötzlicher Bruch in der Aussprache	n.
tìfyawìntxu	Führung, Beratung, Leitung	n.
tìhawnu	Schutz, Bewahrung	n.
tìkangkem	Arbeit	n.
tìkawng	Böse, Übel, Sünde	n.
tìkenong	Beispiel, Muster	n.
tìkin	Bedarf, Bedürfnis, Erfordernis	n.
tìlor	Schönheit	n.
tìng	geben	vtr.
tìng mikyun	zuhören, hinhören	vin.
tìng nari	schauen, hinsehen, anschauen	vin.
tìngay	Wahrheit, Richtigkeit	n.
tìpawm	Frage	n.
tìran	laufen, wandern, gehen	vin.
tìyawn	Liebe	n.
tìrey	Leben, Lebensdauer	n.
tìrol	Lied, Song, Gesang	n.
tìspxin	Kranksein, Zustand des Krankseins	n.
tìtxur	Stärke, Kraft	n.
to	Komparativ Marker als (verhält sich wie eine adp.)	part.
tok	sein (räumlich), zugegen sein, Platz belegen	vtr.
toktor	Doktor	n.
tokx	Körper, Leib	n.
tompa	Regen	n.
toruk	Großer Leonopteryx, Letzter Schatten	n.
toruk makto	Reiter des Toruk, Reiter des Letzten Schatten	n.
torukspxam	Octoshroom, grosser Leonopteryx Pilz, fungimonium giganteum	n.
trr	Tag	n.
trram	gestern	adv.
tukru	Speer, Spieß	n.
tul	rennen, laufen	vin.
tung	erlauben, gestatten	vtr.
tupe	Wer? (welche Person?)	inter.
tut	Partikel der Weiterführung (z.B. nga tut und du? )	part.
tute	Person, Mensch (Na'vi)	n.
tuté	Frau, weibliche Person	n.
tutan	Mann, männliche Person	n.
tsa'u	jenes, das (Ding)	dem.
tsaheylu	Band, (neurale) Verbindung	n.
tsakem	das (diese Aktion)	dem.
tsakrr	da, dann, zu diesem Zeitpunkt, jene Zeit	adv.
tsam	Krieg	n.
tsampongu	Kriegspartei, Gruppe von Kriegern	n.
tsamsiyu	Krieger	n.
tsap'alute	Entschuldigung	n.
tsatseng	dort, da, jener Platz	dem., n.
tsatu	der, die, diese Person (da)	dem.
tsawke	Sonne	n.
tsawl	groß, hochgewachsen	adj.
tsawlapxangrr	Unideltabaum, wörtl. Große dicke Wurzel, magellum deltoids	n.
tse'a	sehen (im physischen Sinne)	vtr.
tseng	Platz, Ort	n.
tsenge	Platz, Ort	n.
tsengpe	Wo? (welcher Ort?)	inter.
tseo	Kunst	n.
tskalep	Armbrust (engl. crossbow)	n.
tsko	Bogen (Waffe)	n.
tsko swizaw	Pfeil und Bogen	n.
tskxe	Stein, Fels, Felsen	n.
tskxekeng	Training, Übung, Ausbildung	n.
tslam	verstehen, begreifen	vtr.
tsleng	falsch, fehlerhaft	adj.
tslolam	verstehe, Ich verstehe	intj.
tsmuk	Geschwister (Singular)	n.
tsmuktu	Geschwister (Singular)	n.
tsmukan	Bruder	n.
tsmuke	Schwester	n.
tsnì	dass (Funktionswort)	sbd.
tsngal	Tasse, Becher, Schale, Gefäß	n.
tspang	töten, umbringen	vtr.
tsranten	bedeuten, von Bedeutung sein, ausmachen	vin.
tstew	tapfer, mutig	adj.
tstxo	Name	n.
tsun	können, in der Lage sein	vim.
tswayon	fliegen	vin.
tsyal	Flügel, Schwinge	n.
tsyo	Mehl, Pulver	n.
tsyorina'wll	Palmfarn, Mehlsamenpflanze, pseudocycas altissima	n.
txan	viel(e), groß (Anzahl)	adj.
txantsan	ausgezeichnet, exzellent, hervorragend	adj.
txantslusam	weise, klug	adj.
txe'lan	Herz	n.
txele	Thema, Angelegenheit, Bewandtnis, Sache	n.
txen	wach, munter	adj.
txep	Feuer, Brand	n.
txewk	Schläger, Knüppel, Keule	n.
txey	anhalten, stoppen, unterbrechen, rasten	v.
txìm	Po, Hintern, Arsch, Hinterteil	n.
txìng	verlassen, zurücklassen, aussetzen, aufgeben	vtr.
txll'u	Hookagourd, Hakenkürbispflanze, flaska ascendens	n.
txo	wenn, falls	conj.
txoa	Vergebung, Verzeihung	n.
txokefyaw	sonst, wenn nicht, ansonsten	conj.
txon	Nacht	n.
txopu	Angst, Furcht	n.
txula	bauen, erbauen, errichten, konstruieren	vtr.
txum	Gift	n.
txumpaywll	Skorpiondistel, giftige Wasserpflanze, scorpioflora maxima	n.
txumtsä'wll	giftspritzende Pflanze, flaska reclinata	n.
txur	stark, kräftig (physisch)	adj.
ulte	und (verbindet Sätze)	conj.
ultxa	Treffen, Versammlung, Zusammenkunft, Begegnung	n.
unil	Traum	n.
uniltìrantokx	Avatar, TraumwandlerKörper	n.
uniltìranyu	Traumwandler	n.
utral	Baum	n.
uvan	Spiel	n.
uvan si	spielen (ein Spiel)	vin.
vay	bis, bis zu, bis hin	adp.
virä	ausbreiten, vermehren, wuchern	v.
vrrtep	Dämon, unheiliger Geist	n.
vul	Ast, Zweig (eines Baumes)	n.
way	Lied, Gesang (alt, zeremoniell)	n.
waytelem	Liedkette, Liedband, Band mit bunten Perlen und Steinen als Erinnerung für die Gesangsgeschichte	n.
win	schnell, rasch	adj.
wìntxu	zeigen, anzeigen	vtr.
'ewll	Pflanze	n.
wrrpa	außen, außen liegend, Außenseite	n., adv.
wutso	Abendessen, Mahlzeit	n.
ya	Luft	n.
yawne	geliebt, lieb	adj.
ye'rìn	bald, demnächst	adv.
yerik	Hexapede, Hirsch ähnliches Tier Pandoras, Sexcruscervus caeruleus	n.
yey	gerade, geradewegs, direkt	adj.
yìm	binden, fesseln, verbinden	vtr.
yol	kurz (kurze Zeit)	adj.
yom	essen, speisen, fressen	vtr.
yomhì'ang	kleiner Tier/Insektenfresser, Dakteron, pseudopenthes coralis	n.
yomioang	Kelchpflanze	n.
yomtìng	füttern, Futter geben (ii)	vin.
yur	waschen; reinigen, säubern (z.B. Wunde)	vtr.
za'ärìp	ziehen	vtr.
za'u	kommen	vin.
zamunge	bringen, herbringen	vtr.
zawng	schreien, kreischen	vin.
zekwä	Finger	n.
zene	müssen	vim.
zìsìt	Jahr	n.
zong	retten, verteidigen, sichern	vtr.
zongtseng	Schutzort, Zuflucht, sicherer Ort, Sicherheit	n.
zoplo	Beleidigung, Vergehen	n.
zusawkrr	Zukunft, in der Zukunft	n.
Jakesully	Trottel, Toruk Maktoyu	n.
'ärìp	bewegen, verschieben (etwas)	vtr.
'awstengyem	verbinden, vereinen (zwei oder mehr Dinge) (ii)	vtr.
'efu	fühlen, spüren, wahrnehmen	vtr.
'em	kochen	vtr.
'eyng	antworten, beantworten, erwidern	v.
'i'a	enden, beenden, abschließen	vin.
'ia	sich verlieren (im spirituellen Sinne)	vin.
fkxake	jucken	v.
fmal	aufrechterhalten, stützen, standhalten	vtr.
frìp	beißen, zubeißen	vtr.
ftem	vorbeigehen, vorübergehen (an etwas)	vtr.
fwew	suchen, streben (nach etwas), aufspüren	vtr.
hangham	lachen	vin.
vaykrr	bis (temporal), bis (dass), bis zu der Zeit	conj.
sngap	stechen	vtr.
hawl	vorbereiten	vtr.
kä'ärìp	drücken, schieben, stoßen	vtr.
kavuk si	betrügen, verraten	vin.
kllkä	absteigen, hinabsteigen, heruntergehen	vin.
latsi	mit jemandem mithalten, mit jemandem Schritt halten	v.
lek	achten, beachten, gehorchen, befolgen	vtr.
len	passieren, geschehen, stattfinden, vorfallen	vin.
lew si	abdecken, verdecken, bedecken	vin.
muntxa si	vereinen (sich mit jemandem), heiraten	vin.
näk	trinken	vtr.
nong	folgen, nachfolgen	vtr.
oeyktìng	erklären (warum), erläutern, begründen (ii)	vtr.
pate	ankommen, zu einem Ort gelangen	v.
piak si	öffnen, aufmachen	vin.
pom	küssen	vtr.
pxor	explodieren	vin.
salew	weiterlaufen, fortfahren, fortsetzen	v.
sar	benutzen, verwenden	vtr.
sim	nah/näher sein	svin.
sleyku	produzieren, herstellen, erzeugen	vtr.
sop	reisen,	vin.
spä	springen, hüpfen	v.
speng	wiederherstellen, zurückversetzen, erneuern	vtr.
spule	antreiben, treiben, vorwärtstreiben	vtr.
srese'a	prophezeien, voraussagen	vtr.
steyki	ärgern, erzürnen, verärgern (jemanden), wütend machen (jemanden)	vtr.
sti	ärgern (sich), verärgert sein, wütend sein	vin.
sto	weigern (etwas zu tun), verweigern, ablehnen	vtrm.
sung	hinzufügen, ergänzen, beigeben, hinzugeben	vtr.
syep	fangen, einschließen, in eine Falle locken, mit einer Falle fangen	vtr.
tatep	(aus den Augen) verlieren	vtr.
tätxaw	zurückkommen, zurückkehren, wiederkommen (intransitiv)	vin.
tem	schießen (intransitiv)	vin.
tì'awm si	kampieren, campen, Lager aufschlagen	vin.
tì'awm	Kampieren, Lagern	n.
tìkangkem si	arbeiten	vin.
tìng tseng	zurückziehen, zurückweichen, Platz machen	vin.
tìsraw seyki	verletzen, wehtun (jemandem oder etwas)	vtr.
tìsraw	Schmerz	n.
tìsraw si	schmerzen, verletzt sein	vin.
toltem	schießen	vtr.
tsä'	spritzen	v.
tsaheyl si	verbinden mit, eine neurale Verbindung eingehen/herstellen	vin.
tsap'alute si	entschuldigen (sich)	vin.
tsawl slu	wachsen	vin.
tsngawvìk	weinen, heulen	vin.
tsre'i	werfen, schleudern	vtr.
tstu si	schließen, zumachen, enden, sperren	vin.
tsunslu	möglich sein	vin.
tsurokx	ausruhen (sich), ruhen, Pause machen, erholen	vin.
tungzup	fallen lassen, herunterlassen, abwerfen	vtr.
wem	kämpfen, sich streiten	vin.
win säpi	beeilen (sich), eilen (sich), hasten	vin.
win si	hetzen, in Eile tun (etwas), schnell tun (etwas), überstürzen	vin.
yän	festmachen, anbringen, festbinden, schnüren	vtr.
yem	setzen, stellen, legen, platzieren	vtr.
zenke	nicht dürfen (ii)	vim.
zup	fallen	vin.
nekll	runter, nach unten (Richtung)	adv.
srung si	helfen, unterstützen	vin.
txopu si	fürchten, befürchten, Angst haben	vin.
fkip	oben zwischen, nach oben zwischen	adp.
io	über, darüber	adp.
kxamlä	durch (durch die Mitte von)	adp.
lok	nahe bei, nahe an	adp.
maw	nach (Zeit)	adp.
mìkam	zwischen (örtl.)	adp.
nemfa	hinein, in, in...hinein	adp.
pxaw	um...herum, rund um	adp.
pxel	wie	adp.
sìn	auf, nach, an, hinauf	adp.
takip	von zwischen, von inmitten	adp.
uo	hinter	adp.
luke	ohne	adp.
tafkip	von oben zwischen	adp.
ro	an, bei (Ortsangabe)	adp.
sre	vor (Zeit)	adp.
wä	gegen (wie bei: kämpfen gegen)	adp.
fäpa	Spitze, Gipfel	n.
alìm	weit weg, in der Ferne	adv.
aylaru	zu den anderen, den anderen	pn.
kxu	Schaden (physisch), Unheil	n.
eltu lefngap	Computer	n.
kì'ong	langsam	adj.
säfpìl	Idee	n.
kefyak	oder nicht?, richtig?	part.
prrwll	Moos	n.
pängkxoyu lekoren	Anwalt, Rechtsanwalt	n.
pamrel	Schrift	n.
pamrel si	schreiben	vin.
furia	dass (NebensatzMarker)	pn., sbd.
fratseng	überall	adv.
fratrr	täglich, jeden Tag	adv.
frato	Superlativ Marker als alles	part.
trray	morgen	adv.
kea	kein, keine/r/s (vor einem Nomen)	adj.
ngian	jedoch, trotzdem, aber	adv.
skepek	formal, förmlich	adj.
hufwa	obwohl	conj.
tup	anstelle, statt, eher als	conj.
'uo	etwas, irgendetwas	pn.
tuteo	jemand, irgendjemand	pn.
tsengo	irgendwo	pn.
holpxaype	Wie viele? (welche Nummer?)	inter.
hìm	klein, wenig (kleine Menge)	adj.
hìmtxampe	Wieviel? (welche Menge?)	inter.
hìmtxan	Menge, Anzahl	n.
pìmtxan	Wieviel? (welche Menge?)	inter.
lì'upe	welches Wort?, welche Äußerung?	inter.
pelì'u	welches Wort?, welche Äußerung?	inter.
ultxarun	begegnen, treffen (zufällig) (ii)	vtr.
ultxa si	treffen (mit jmd., absichtlich) (benutze hu mit)	vin.
rangal	wünschen	vin.
nìrangal	Wunsch (im Gegensatz zur Tatsache, mit perfektivem oder imperfektivem Subjunktiv)	adv.
txepvi	Funke	n.
nitram	fröhlich, glücklich (bei Personen)	adj.
fewi	verfolgen, jagen	vtr.
stä'nì	fangen, auffangen, erwischen	vtr.
sran	ja (umgangssprachlich)	part., intj.
weyn	zeichnen, darstellen (bildlich)	vtr.
fìtrr	heute	adv.
rusey	lebending, lebend, am Leben, lebendiges Ding	adj., n.
vitra	Seele	n.
nìzawnong	wohlbehalten, sicher	adv.
ftawnemkrr	Vergangenheit	n.
txal	Rücken, Rückseite (des Körpers)	n.
tsìng	vier	num.
mrr	fünf	num.
pukap	sechs	num.
kinä	sieben	num.
vol	acht	num.
zam	vierundsechzig	num.
tìoeyktìng	Erklärung	n.
lesar	brauchbar, nützlich	adj.
tse	nun, also, tja (Konversationsbeginn)	part.
skxom	Möglichkeit, Chance, Gelegenheit	n.
fkxen	Gemüse (Essen)	n.
syä'ä	bitter, herb (Geschmack)	adj.
yemfpay si	eintauchen, eintunken	vin.
yemfpay	Eintauchen, Eintunken (in Flüssigkeit)	n.
keng	gar, selbst, sogar	adv.
'awlo	einmal	adv.
melo	zweimal	adv.
heyn	sitzen	vin.
nìpxim	gerade, aufrecht	adv.
pxim	aufrecht, gerade	adj.
tuvon	lehnen, anlehnen	v.
nìfya'o	auf eine Art und Weise	adv.
letrrtrr	gewöhnlich, normal, alltäglich	adj.
nì'eoio	zeremoniell, feierlich	adv.
'eoio	zeremoniell, feierlich	adj.
rìk	Blatt (eines Baumes)	n.
lerìk	belaubt	adj.
pa'o	Seite (Position)	n.
kllpa	Boden, Unterseite, Unterteil	n.
mìfa	Innenseite, innen, innseitig	n., adv.
nefä	nach oben, oben (Richtung)	adv.
zapxì	Vorderseite (Teil oder Abschnitt)	n.
käpxì	Rückseite (Teil oder Abschnitt)	n.
käsatseng	draußen, dort draußen	adv.
ftxey	entweder … oder, ob	conj.
ngaytxoa	Entschulding, Sorry (Annehmen von Schuld und Reue)	intj.
flew	Rachen, Kehle	n.
kxa	Mund	n.
nikre	Haar	n.
pewn	Hals	n.
re'o	Kopf	n.
sre'	Zahn	n.
tsuksìm	Kinn	n.
key	Gesicht	n.
puk	Buch	n.
ngäng	Bauch, Magen	n.
ta'leng	Haut	n.
tsyokx	Hand	n.
reypay	Blut	n.
tsopì	Lunge	n.
venu	Fuß	n.
venzek	Zehe	n.
ramunong	Brunnen	n.
payfya	Strom, Fluss	n.
pxawpa	Grenze, Umfang, Begrenzung, Eingrenzun	n.
txampay	Ozean, Meer	n.
'ora	(der) See	n.
ekxan	Barrikade, Hindernis	n.
tsim	Quelle	n.
tsray	Dorf	n.
txayo	Feld, offenes Gelände, Ebene	n.
ukxo	trocken	adj.
wew	kalt	adj.
fìtxon	heute Nacht	adv., n.
txonam	letzte Nacht	adv.
txonay	morgen Nacht	adv.
sekrr	Gegenwart	n.
vur	Geschichte, Erzählung	n.
tìpängkxo	Unterhaltung, Diskussion	n.
tìsrese'a	Prophezeiung	n.
nawmtu	ehrwürdige Person, großartige Person	n.
txantstew	Held	n.
syuve	Nahrung, Essen (Sammelbegriff, kein Plural möglich)	n.
tsngan	Fleisch	n.
tstal	Messer	n.
tete	stumpf (z.B. Klinge)	adj.
lew	Abdeckung, Deckel, Topfdeckel	n.
'opin	Farbe	n.
leNa'vi	"na'viisch", mit den Na'vi zu tun habend	adj.
nìNa'vi	"na'viisch", wie die Na'vi	adv.
hapxìtu	Mitglied	n.
'Rrta	Erde (Planet)	prop.n.
fwäkìwll	GottesanbeterOrchidee (Pflanze)	n.
hì'ang	Insekt	n.
payoang	Fisch	n.
yayo	Vogel	n.
zize'	Höllenfeuerwespe (Insekt)	n.
kemlì'u	Verb, Tuwort	n.
tstxolì'u	Substantiv	n.
ftär	links (nicht rechts)	adj.
skien	rechts (nicht links)	adj.
'änsyem	komplett, gesamt	adj.
wotx	Gesamtheit, Ganze	n.
mowan	angenehm, ansprechend (körperlich, sexuell)	adj.
vä'	unangenehm für die Sinne, widerlich	adj.
tatlam	anscheinend	adv.
keteng	unterschiedlich	adj.
numtseng	Schule	n.
skxakep	wahrscheinlich, vermutlich	adj., adv.
tìprrte'	Vergnügen, Spaß	n.
kaw'it	überhaupt (nur mit Verneinung) (s. ke...kaw'it überhaupt nicht)	adv.
nìlkeftang	ständig, andauernd, unaufhörlich	adv.
tì'i'avay	bis zum Ende	adv.
'awm	Lager	n.
tìska'a	Zerstörung	n.
tìsop	Reise	n.
wempongu	Squad, Kampfeinheit	n.
asim	nahe, in kurzer Entfernung	adv.
klltseng	Position	n.
kxutu	Feind	n.
mekre	Nachschub, Versorgungsgüter	n.
tìhawl	Vorbereitungen, Plan	n.
tìkan	Ziel, Absicht, Vorhaben	n.
tìpähem	Ankunft	n.
numeyu	Schüler, Student	n.
soaia	Familie (unregelmäßiger Genitiv soaiä)	n.
tìmuntxa	Paarung, Heirat, Verpartnerung	n.
yawnetu	geliebte Person	n.
yawntu	geliebte Person	n.
kakrel	blind	adj.
kanu	klug, intelligent	adj.
koak	alt, gealtert (für Lebewesen)	adj.
lekye'ung	wahnsinnig, verrückt	adj.
me'em	harmonisch	adj.
txanew	geizig, gierig	adj.
txantur	machtvoll, mächtig	adj.
tì'awpo	Individualität (negativ), Egoismus, Selbstsucht	n.
tì'eylan	Freundschaft	n.
fkay	verhasst, verabscheut	adj.
keltsun	unmöglich	adj.
kxuke	sicher, unbeschadet	adj.
lehawng	übermäßig, übertrieben	adj.
hawng	Übermaß, Fülle	n.
lekin	notwendig, nötig	adj.
stxong	seltsam, merkwürdig, ungewohnt, unbekannt	adj.
syen	letzte/r/s, endgültig, abschließend	adj.
kavuk	Verrat	n.
fpìlfya	Gedankengang	n.
syay	Schicksal	n.
tìfnu	Stille, Ruhe	n.
tìngop	Kreation, Schaffung, Schöpfung (abstrakt)	n.
tìpe'un	Entscheidung	n.
kxitx	Tod	n.
trr'awve	Sonntag	n.
trrmuve	Montag	n.
trrpxeyve	Dienstag	n.
trrtsìve	Mittwoch	n.
trrmrrve	Donnerstag	n.
trrpuve	Freitag	n.
trrkive	Samstag, Sonnabend	n.
'ango	leise, weich, sanft (Klang/Geräusch)	adj.
kxayl	hoch	adj.
rey'eng	das Gleichgewicht des Lebens	n.
tìme'em	Harmonie (allgemein)	n.
fnel	Art, Typus	n.
fnepe	was? (welche Art von?)	inter.
pefnel	was? (welche Art von?)	inter.
zerok	erinnern	vtr.
tswa'	vergessen	vtr.
tì'efu	Gefühl	n.
maweypey	geduldig sein, gedulden (ii)	svin.
tìmweypey	Geduld	n.
lemweypey	geduldig	adj.
nìmweypey	geduldig, auf geduldige Weise	adv.
tsakrrvay	bis dann, in der Zwischenzeit	adv.
ohakx	hungrig	adj.
tìohakx	Hunger	n.
tsyosyu	Essen, Nahrung (aus Mehl)	n.
vey	Essen, Nahrung (von tierischem Ursprung), Fleisch	n.
trrpeve	welcher Tag? (abgeleitet von trr Tag und pe Fragepartikel und ve Ordnungszahlmarker)	inter.
pxiswawam	gerade eben	adv.
pxiset	jetzt gerade	adv.
pxiswaway	jetzt gleich	adv.
pxiye'rìn	gleich (nicht so bald wie pxiswaway)	adv.
pxisre	direkt vor (zeitl.)	adp.
pximaw	direkt nach (zeitl.)	adp.
sok	kürzlich, jüngst, in letzer Zeit	adj.
'awlie	einstmals	adv.
tìkxey	Inkorrektheit, Fehlerhaftigkeit	n.
tìkxey si	einen Fehler machen, vermasseln	vin.
tìyawr	Korrektheit, Richtigkeit	n.
tìketeng	Unterschied	n.
fpomtokx	(physische) Gesundheit	n.
lefpomtokx	(physisch) gesund	adj.
kelfpomtokx	(physisch) ungesund	adj.
keftxo	unglücklich, aufgebracht, 'Wie traurig!'	adj., intj.
nìkeftxo	leider, unglücklicherweise	adv.
sraw	schmerzhaft	adj.
txampxì	Mehrheit, Großteil	n.
vurvi	Zusammenfassung	n.
sänumvi	Lektion, Übung, Unterricht	n.
letam	genügend, ausreichend	adj.
letsranten	wichtig	adj.
nìswey	optimalerweise, bestens	adv.
nìpxi	treffend, unmissverständlich	adv.
wok	laut	adj.
spuwin	alt, ehemalig	adj.
nì'eyng	als Antwort, in Erwiderung auf	adv.
nìkanu	intelligent, auf intelligente Weise	adv.
nìlaw	klar, offensichtlich	adv.
tìsti	Ärger, Zorn	n.
tìtxanew	Gier	n.
tìftxey	Wahl	n.
tìkanu	Intelligenz, Klugheit	n.
tìlam	Aussehen, Erscheinungsbild	n.
tìtslam	Verständnis, Erkenntnis; Information (milit.)	n.
tìtxula	Konstuktion, Konstrukt	n.
hewne	weich (von einem Objekt)	adj.
tìm	niedrig	adj.
laro	sauber	adj.
tsewtx	dreckig, schmutzig	adj.
lefngap	metallisch	adj.
txa'	hart	adj.
fwel	kaputt, zerbrochen	adj.
etrìp	vielversprechend, vorteilhaft	adj.
piak	offen, geöffnet; wolkenlos	adj.
tstu	zu, geschlossen; wolkenverhangen, bedeckt	adj.
kxll si	stürmen, angreifen	vin.
tsaw	es, das (als intransitives Subjekt)	dem., pn.
tsalsungay	dennoch, trotzdem, allerdings	adv.
oìsss	verärgertes Knurren, "Pass doch auf!"	intj.
saa	drohender Schrei	intj.
sau	Ausruf der Anstrengung, "Uff!"	intj.
tsahey	Ausruf der Warnung oder Frustration, 'Ach, Mist!'	intj.
wiya	Ausruf der Warnung oder Frustration, 'Verdammt!'	intj.
ìley	Kriegsgeschrei	intj.
vawm	dunkel, finster	adj.
tìvawm	Dunkelheit, Finsternis	n.
polpxay	wie viele? (welche Anzahl?)	inter.
ke'aw	uneins, zerstritten	adj.
nìsti	verärgert, wütend, zornig	adv.
teyr	weiß (Farbe)	adj.
layon	schwarz	adj.
pänu	Versprechen	n.
kew	Null, '0'	num.
'eyt	das Zeichen '8' (nicht der Wert 'acht')	n.
nayn	das Zeichen '9' (nicht der Wert 'neun')	n.
trr'ong	Morgengrauen	n.
trr'ongmaw	nach dem Morgengrauen	n.
rewon	Morgen	n.
srekamtrr	die Zeitspanne vor Mittag	n.
kxamtrr	Mittag, Mitte des Tages	n.
kxamtrrmaw	Zeit nach Mittag	n.
ha'ngir	Nachmittag	n.
kaym	Abend, später Nachmittag (vor Dämmerung)	n.
sreton'ong	Zeit vor der Dämmerung	n.
txon'ong	Dämmerung, Sonnenuntergang	n.
txon'ongmaw	Zeit nach der Dämmerung, Nachteinfall	n.
srekamtxon	Zeit vor Mitternacht	n.
kxamtxon	Mitternacht, Mitte der Nacht	n.
kxamtxomaw	nach Mitternacht	n.
sresrr'ong	vor Morgengrauen	n.
wou	aufregend, faszinierend sein (Umgangssprache) (mit DativSubjekt)	svin.
tsyìräfì	Giraffe (Lehnwort)	n.
tsawa	das (Relativpronomen)	pn., sbd.
tsata	das (Relativpronomen)	pn., sbd.
tsaria	das (Relativpronomen)	pn., sbd.
alo	Mal (eine Reihe von sich wiederholenden Handlungen); Reihe, am Zug sein	n.
fralo	jedes Mal	adv.
nìmwey	ruhig, friedlich	adv.
ku'up	schwer (Gewicht)	adj.
syo	leicht (Gewicht)	adj.
hay	nächste/r/s, folgende/r/s	adj.
ham	letzte/r/s, vorige/r/s	adj.
matsa	Matze (jiddisches Lehnwort); ungesäuertes Brot	n.
hametsì	Gesäuertes, Sauerteig (jiddisches Lehnwort)	n.
tìkangkemvi	Projekt, Teil einer Arbeit	n.
nì'i'a	endlich, zu guter Letzt	adv.
nìsyen	schließlich, als Letztes, zum Schluss	adv.
pìlok	Blog, Weblog, Internettagebuch	n.
tsulfätu	Experte, Meister einer Fähigkeit, Kunst, Handwerk	n.
tsulfä	(herausragendes) Können	n.
tsulfä si	meistern	vin.
numtsengvi	Klassenzimmer, Einteilung einer Schule	n.
rofa	neben, nebenher	adp.
pum	derjenige, dasjenige (Platzhalterpronomen, das sich auf ein vorher erwähntes Nomen oder Pronomen bezieht)	pn.
Yuesey	USA, Vereinigte Staaten von Amerika	prop.n.
teya si	füllen (Dativ für die Sache, die gefüllt wird)	vin.
alunta	weil, aus dem Grund, dass…	conj.
nìprrte'	auf vergnügliche Weise, gerne, mit Vergnügen	adv.
sngä'iyu	Anfänger	n.
srekrr	vor, davor, zuvor, schon	adv.
ayu	Dinge, Sachen	n.
tsafya	so, auf jene Weise	adv.
muve	zweite/r/s (Ordnungszahl)	adj.
pxeyve	dritte/r/s (Ordnungszahl)	adj.
tsìve	vierte/r/s (Ordnungszahl)	adj.
mrrve	fünfte/r/s (Ordnungszahl)	adj.
puve	sechste/r/s (Ordnungszahl)	adj.
kive	siebente/r/s (Ordnungszahl)	adj.
volve	achte/r/s (Ordnungszahl)	adj.
tsyänel	Fernseh/Radiosender	n.
trrtxon	der TagundNachtZyklus auf Pandora	n.
au	Ausruf der Betroffenheit	intj.
pängkxoyu	Gesprächspartner	n.
lekoren	rechtlich, die Regel betreffend	adj.
prrkxentrrkrr	Tageszeitraucherspaß, vibrierende Zunge (Na'viIdiom)	n.
tìftia	Studium	n.
tìftia kifkeyä	Wissenschaft, Studium der physischen Welt	n.
pxir	Bier	n.
eanean	Cheadle (ein Kraut), thylakoidia spiralis	n.
'ele'wll	Dornige Tatze (ein Kaktus)	n.
tstxa'a	Canalyd, Schneckenähnliche, canalydium limacineum	n.
pa'liwll	Pa'liKannenblatt, pseudocenia equina	n.
anìheyu	Fibonacci, Blauer Spiralfarn, orbis caeruleus	n.
tompawll	Geode, Regenpflanze, Blauer Zapfen, tubineus azureus	n.
pxiwll	Einsiedlerknospenpflanze (Artischocke ähnlich), cynaroidia discolor	n.
syeptute	Hyneman (Cobralilien ähnlich), Menschenfalle, pandoratonia myopora	n.
kllpxiwll	Löwenbeere (Artischocken ähnlich), cynaroidia decumbens	n.
smaoe	Phalanxia, starkgedornte Pflanze, phalanxia ferox	n.
'ä'o	Kannenblattpflanze	n.
mulpxar	Hahnenkopf, alectophyllum molle	n.
flefle	Sols Entzücken (Kalamar ähnliche Pflanze), calamariphyllum elegans	n.
kxaylte	Cillaphant, Purpurne Tatze, clawenia purpurea	n.
fkxakewll	Diestelknospe, Juckpflanze, Cynaroidia glauca	n.
tìhawnuwll	Spartaner, Beschützerpflanze Kuchenium Polyphyllum	n.
pxorna'lor	Sari, Schöne explodierende Samen Pflanze, Pandargonium cyanellum	n.
pxayzekwä	Dornige Peitschenpflanze; Phytotinium Poydactylum	n.
mìnyu	Falsche Lilie, Pseudolilium Contortum	n.
mìnyu	Dreher, Drechsler	n.
väfewll	Grüne Tausendfüßerpflanze, Stinkpflanze, Scolopendra virens	n.
sngukx	Raupenpflanze, Limacina erecta	n.
rawp	Blasenpolyp, polypiferus brevisimus	n.
'ampirikx	KannenblattPflanze, pseudocenia simplex	n.
apxangrr	Deltabaum, Magellum triangulare	n.
värumut	Venentopf, Obesus fenestralis	n.
keyawr	inkorrekt, nicht richtig, falsch	adj.
lehrrap	gefährlich	adj.
tìtxen	Phase des Wachseins, Wachheit	n.
hìrumwll	Beutelpflanze	n.
fwäkì	Gottesanbeterin (Insekt)	n.
fratxon	jede Nacht	adv.
hìkrr	Sekunde, sehr kurze Zeit	n.
mawkrr	nach, danach	adv.
ngeyn	müde	adj.
ngopyu	Schaffender, Schöpfer	n.
nìk'ong	langsam	adv.
pamtseotu	Musiker	n.
sat	das	pn.
tsal	das, es (transitives Subjekt)	pn.
tsat	das, es (als Objekt)	pn.
tsawlhì'	Größe	n.
lì'fyavi	Ausdruck, Sprachteil	n.
nafì'u	so, solche/r/s	adj.
lì'fyaolo'	Sprachgruppe, Sprachbenutzer, Sprachbund	n.
puktsyìp	Broschüre, Pamphlet	n.
utraltsyìp	Busch	n.
säspxintsyìp	Wehwehchen, kleine Krankheit	n.
'itetsyìp	kleine Tochter (Ausdruck der Zuneigung)	n.
sa'nutsyìp	kleine Mama (für junge Mädchen)	n.
kem si	tun, machen	vin.
tswin	Queue, geflochtener Zopf (für tsaheylu)	n.
tswintsyìp	Zöpfchen, kleiner Queue	n.
taronyutsyìp	kleiner Jäger	n.
oetsyìp	ich Kleines	pn.
ngatsyìp	du Kleines	pn.
atanvi	Lichtstrahl	n.
txeptsyìp	niedliches, kleines Feuerchen	n.
tìkusar	das Lehren (Vorgang)	n.
tìyusom	das Essen (Vorgang)	n.
tìtusaron	das Jagen	n.
tìpängkxotsyìp	kleines Gespräch	n.
hayalo	nächstes Mal	adv.
hamalo	letztes Mal	adv.
tstunwi	nett, aufmerksam, rücksichtsvoll	adj.
seykxel	stark (emotional, spirituell, nicht physisch)	adj.
fuke	oder nicht	conj.
'a'aw	einige, etliche	adj.
'okrol	(alte) Geschichte	n.
'okvur	(jüngere) Geschichte, Historie	n.
alu	das heißt, soll heißen, mit anderen Worten	conj.
fnawe'	feige	adj.
fnawe'tu	Feigling	n.
ftxìlor	gutschmeckend, lecker, schmackhaft	adj.
ftxìvä'	schlechtschmeckend, widerlich	adj.
fyeyn	reif, erwachsen, mündig	adj.
fyeyntu	Erwachsener, erwachsene Person	n.
tìfyeyn	Reife, Mündigkeit	n.
hawngkrr	spät	adv.
lehawngkrr	spät, verspätet	adj.
leye'krr	früh, zeitig	adj.
hek	kurios sein, unerwartet sein	vin.
nìhek	merkwürdigerweise, seltsamerweise	adv.
ki	sondern	conj.
nìfyeyntu	wie ein Erwachsener, erwachsen	adv.
nì'eveng	wie ein Kind, kindlich	adv.
lìng	in der Luft schweben	vin.
ram	Berg, Gebirge	n.
muntxatu	Ehepartner	n.
muntxatan	Ehemann	n.
muntxate	Ehefrau	n.
netrìp	glücklicherweise, zum Glück	adv.
newomum	neugierig sein, wissen wollen	svin.
lenomum	neugierig	adj.
tìnomum	Neugier, Neugierde	n.
ngäzìk	schwierig, schwer	adj.
tìngäzìk	Schwierigkeit, Problem	n.
nìsung	außerdem, überdies, ferner	adv.
reng	seicht, flach (physisch)	adj.
rolun	Heureka! Ich hab's!	intj.
sa'sem	Eltern (Mutter und Vater); Elternteil	n.
smar	Beute, gejagte Sache	n.
starsìm	einsammeln, sammeln, zusammenklauben	vtr.
sunu	gefallen, gern mögen, Freude bringen	vin.
syayvi	Glück, Zufall	n.
nìsyayvi	per Zufall, zufällig	adv.
tolel	Heureka! Ich hab's verstanden!	intj.
txukx	tief (physisch)	adj.
ve'kì	hassen	vtr.
tìve'kì	Hass	n.
yaymak	dumm, töricht, ungebildet	adj.
ye'krr	früh	adv.
zìsìkrr	Jahreszeit, Saison	n.
zo	gutgehen, intakt sein; sein, wie es die Natur vorgesehen hat	svin.
zoslu	gut werden, geheilt sein (ii)	vin.
zeyko	heilen, reparieren	vtr.
frawzo	alles ist gut, alles ist in Ordnung	intj.
kemlì'uvi	Infix	n.
irayo si	danken; Dank geben	vin.
lefkrr	momentan, derzeit, gegenwärtig	adj.
lì'upam	Aussprache	n.
natkenong	zum Beispiel, beispielsweise	conj.
eltur tìtxen si	interessant sein, faszinierend sein	vin.
pxelo	dreimal	adv.
pamrelfya	Schreibweise	n.
law si	klar machen, verdeutlichen	vin.
tìsung	Hinzufügung; post scriptum (PS)	n.
naer	Getränk, etwas Trinkbares	n.
atxkxerel	Landkarte	n.
nìtengfya	auf die gleiche Art und Weise (ähnliche Handlung)	adv.
tun	rot, orange	adj.
'om	violett, lila, purpur, magenta	adj.
neyn	helle Farben, Weißtöne	adj.
ngul	grau, graubraun, trist	adj.
tumpin	Rot, Orange	n.
eampin	Blau, Grün	n.
rimpin	Gelb	n.
'ompin	Violett, Lila, Purpur, Magenta	n.
layompin	Schwarz	n.
teyrpin	Weiß	n.
vawmpin	dunkle Farbe	n.
neympin	helle Farbe	n.
ngulpin	Grau	n.
pil	Gesichtsstreifen, natürliche Maserung der Na'vi	n.
ta'lengean	hautblau, blaue Hautfarbe der Na'vi	adj.
rìkean	blattgrün	adj.
kllvawm	braun	adj.
'evan	Junge (umgangssprachlich)	n.
'eve	Mädchen (umgangssprachlich)	n.
'evengan	Junge	n.
'evenge	Mädchen	n.
fkio	Tetrapteron, Flamingo ähnlicher Vogel Pandoras	n.
kenten	Fächerechse, Fanisaurus pennatus, geflügelte Fächerechse	n.
nìwä	im Gegensatz, im Gegenteil, andererseits	adv.
pìwopx	Wolke	n.
ramtsyìp	Hügel, kleiner Berg	n.
syaksyuk	Prolemuris, Lemuren ähnliche Affenart Pandoras, Prolemuris noctis	n.
tor	endgültig, ein Ende bringend	adj.
txärem	Knochen	n.
uk	Schatten	n.
yapay	Nebel, Dunst, (Wasser)Dampf	n.
tìspe'e	Gefangennahme, Fang	n.
tìftxavang	Leidenschaft	n.
tìtstunwi	Nettigkeit, Aufmerksamkeit, Rücksicht	n.
stxeli	Geschenk	n.
ngrrpongu	Basisbewegung, Volksbewegung	n.
smon	vertraut sein, jemanden kennen (mit Dativ)	vin.
lawk	über jemanden reden, über etwas reden	vtr.
hìtxoa	Verzeihung, Entschuldigung	intj.
mäkxu	unterbrechen, aus der harmonischen Balance bringen (für Aktivitäten, Umstände)	vtr.
hultstxem	hindern, jmd. unterbrechen, jdm. im Weg sein, ein Hindernis sein	vtr.
mok	vorschlagen	vtr.
muwìntxu	jmd., et. vorstellen, präsentieren	vtr.
kan'ìn	konzentrieren, spezialisieren, interessiert sein	vtr.
tìwusem	das Kämpfen	n.
nì'eng	gleichbereichtigt, auf gleicher Stufe, auf gleicher Ebene	adv.
Pari	Paris (Hauptstadt Frankreichs)	prop.n.
tì'ong	Aufblühen, Ausblühen	n.
tìmok	Vorschlag (abstrakt), das Vorschlagen	n.
tì'em	Kochen, Kochkunst	n.
leyn	wiederholen, noch einmal tun	vtr.
päsketpol	Basketball	n.
nìFranse	französisch, in Französisch	adv.
nìToitsye	deutsch, in Deutsch	adv.
nìno	im Detail, genau, detailiert	adv.
hìno	detailiert, präzise, genau (für Dinge)	adj.
leno	genau, detailorientiert, gründlich (für Menschen)	adj.
tìno	Gründlichkeit, Liebe zum Detail	n.
'ongokx	geboren werden	vin.
nokx	gebären	vtr.
nìtrrtrr	täglich, regelmäßig, in täglicher Weise	adv.
tìn	Tätigkeit, die einen beschäftigt hält	n.
txin	hauptsächlich, Haupt, pimär, wichtigste	adj.
txintìn	Beruf, Hauptbeschäftigung in der Gesellschaft	n.
'emyu	Koch	n.
vewng	kümmern um, sorgen um, verantwortlich sein für	vtr.
kaltxì si	grüßen, Hallo sagen	vin.
sopyu	Reisender	n.
fula	das, diese Sache, dass (RelativsatzEinleiter)	pn., sbd.
tskxekeng si	üben, trainieren	vin.
way si	singen	vin.
swawtsyìp	kleiner Moment, Momentchen, Augenblickchen, Sekunde	n.
käteng	Zeit verbringen	vin.
'ìn	beschäftigt sein	svin.
Sweriye	Schweden	prop.n.
nìfkrr	in letzter Zeit, derzeitig, zurzeit	adv.
sulìn	beschäftigt sein (positiv), in etwas vertieft sein, das man besonders gern macht	svin.
vrrìn	beschäftigt sein (negativ): von einer Aktivität überfordert oder ermüdet sein	svin.
tìk'ìn	Freizeit, Abwesenheit von Geschäftigkeit	n.
säsulìn	Hobby, freudebringende Tätigkeit	n.
'o'	lustig, spaßig, aufregend, Spaß bringend	adj.
Europa	Europa	prop.n.
skxaypxe	Skype	n.
pxorpam	Ejektiv, ejektiver Konsonant	n.
tì'o'	Spaß, Aufregung	n.
nì'o'	auf eine lustige Art und Weise	adv.
fnan	gut sein in etwas	vtr.
wätx	schlecht sein in etwas	vtr.
tìsom	Hitze	n.
tìwew	Kälte	n.
tìlen	Ereignis, Geschehen, Veranstaltung	n.
nìnäk	trinkend, in flüssiger Weise	adv.
nìhay	nächster	adv.
sayrìp	gutaussehend, attraktiv	adj.
letokx	körperlich, physisch	adj.
säzärìp	Zügel	n.
ìpxa	Farn, Farnkraut	n.
tìhawnu si	beschützen	vin.
sno	er, sie, es selbst (reflexive Gentivform sneyä)	pn.
kìte'e si	dienen	vin.
var	in einem Zustand bleiben, eine Handlung fortführen, weitermachen	vim.
nìftxan	so, derart, dermaßen	adv.
Yeysu	Jesus	prop.n.
lelì'fya	Sprach, die Sprache betreffend	adj.
takrra	seit (zeitlich)	conj.
akrrta	seit (zeitlich)	conj.
few	hinüber, über, die andere Seite erreichen wollend	adp.
fewtusok	gegenüberliegend, andere Seite	adj.
sla'tsu	beschreiben	vtr.
tìsla'tsu	Beschreibung	n.
'en	begründete Vermutung, Intuition	n.
'en si	vermuten, eine begründete Vermutung machen	vin.
le'en	spekulativ, auf Vermutung beruhend	adj.
nì'en	eine begründete Vermutung machend, aufgrund von Intuition handeln	adv.
sä'o	Werkzeug, Gerät	n.
pamtseo si	Musik spielen (mit fa für Instrumente)	vin.
väng	durstig	adj.
tìväng	Durst	n.
sngum	Sorge, Besorgnis, Befürchtung	n.
nìsngum	besorgniserrende Weise	adv.
yayayr	Verwirrung, Durcheinander, Verwirrtheit	n.
wäte	bestreiten, anfechten, streiten	vtr.
tìwäte	Streit, Auseinandersetzung	n.
säwäte	Streitpunkt, Streitgrund	n.
lewäte	umstritten	adj.
nìwäte	in unangenehmer Weise	adv.
li	schon, bereits	adv.
lisre	bis (spätestens)	adp.
ronsrelngop	sich etwas vorstellen, ausmalen, imaginieren (komp. aus ronsem Geist, rel Bild, ngop erschaffen, Umgangssprache [Ron.sREw.Nop] )	vtr.
ronsrel	Vorgestelltes, Ausgemaltes, Imaginiertes	n.
tìronsrel	Vorstellungskraft	n.
txanatan	strahlend, lebhaft, anschaulich, lebendig	adj.
leronsrel	imaginär, Phantasie, vorgestellt	adj.
nìronsrel	in der Vorstellung, in der Phantasie	adv.
srefey	erwarten, voraussetzen, annehmen	vtr., vin.
mawl	Hälfte, einhalb	n.
pan	Drittel, eindrittel	n.
wan	verstecken	vtr.
nìwan	heimlich, geheim, in geheimer weise	adv.
tìwan	Geheimnis, Verschleierung, Geheimhaltung	n.
letwan	gewieft, raffiniert (von einer Person)	adj.
slele	schwimmen	vin.
nìslele	schwimmend, auf schwimmende Weise	adv.
tìtaron	das Jagen	n.
ìì	ähm	intj.
tsukyom	essbar	adj.
ketsuktswa'	unvergesslich	adj.
tsuktswa'	vergesslich	adj.
yafkeyk	Wetter	n.
fkeytok	existieren	vin.
tìfkeytok	Zustand, Beschaffenheit, Situation	n.
tompameyp	Sprühregen, Nieselregen	n.
tskxaytsyìp	Hagel	n.
tskxepay	Eis	n.
herwì	Schnee	n.
tomperwì	Graupel, Schneeregen	n.
txanfwerwì	Schneesturm, Blizzard	n.
hermeyp	Schneegestöber, leichter Schneeschauer	n.
hertxayo	Schneedecke	n.
ìlva	Flocke, Tropfen, Span, Splitter	n.
txepìva	Asche, Schlacke	n.
herwìva	Schneeflocke	n.
payìva	Wassertropfen	n.
tompìva	Regentropfen	n.
kintrr	Woche (7TageWoche)	n.
mrrtrr	Woche (5TageWoche)	n.
muntrr	Wochenende	n.
kintrram	letzte Woche	n.
kintrray	nächste Woche	n.
muntrram	letztes Wochenende	n.
muntrray	nächstes Wochenende	n.
vospxì	Monat	n.
vospxìam	letzter Monat	n.
vospxìay	nächster Monat	n.
sweylu	sollen	v.
ye	zufrieden; gesättigt, voll	adj.
hasey si	vollenden, vollbringen, et. beenden, et. schaffen	vin.
seysonìltsan	Gut gemacht! Gute Arbeit! (von hasey soli nìltsan gut vollendet)	intj.
yehakx	satt, voll (Hungergefühl)	adj.
yeväng	nicht mehr durstig, gestillt	adj.
somwew	Temperatur	n.
pup	kurz (physische Länge)	adj.
ngimpup	Länge, Strecke	n.
pesomwew	welche Temperatur?	inter.
somwewpe	welche Temperatur? (gebräuchlicher)	inter.
txawew	sehr kalt	adj.
wur	kühl	adj.
tsyafe	mild, gemäßigt, angenehm (Wetter/Temperatur)	adj.
sang	warm	adj.
txasom	sehr heiß	adj.
leyapay	neblig, diesig	adj.
lepwopx	wolkig, bewölkt	adj.
nìhol	wenig, in weniger Weise	adv.
nìpxay	viel, in großer Anzahl	adv.
paynga'	feucht, feuchtkalt, klamm	adj.
meuianga'	ehrenhaft, ehrenwert	adj.
txumnga'	giftig, gifthaltig	adj.
'akra	(fruchtbarer) Boden, Boden (auf dem Pflanzen wachsen können)	n.
hufwetsyìp	Lüftchen, Brise	n.
nìlam	anscheinend, offensichtlich, offenbar	adv.
nìli	im Voraus	adv.
nìfrakrr	wie immer	adv.
am'a	Zweifel, Bedenken	n.
nga'	enthalten, beinhalten, umfassen	vtr.
tìftang si	stoppen (jemanden, etwas)	vin.
may'	versuchen, ausprobieren, probieren, kosten, testen	vtrm.
yora'	gewinnen	vtr.
snaytx	verlieren	vtr.
tìyora'	Sieg	n.
tìsnaytx	Niederlage	n.
'otxang	Musikinstrument	n.
skxir	Wunde	n.
leskxir	verwundet	adj.
skxir si	verwunden	vin.
skxirtsyìp	Schnitt, Prellung, leichte Verletzung	n.
sloan	eingießen, einschütten, gießen, schütten	vtr.
emrey	überleben	vin.
temrey	Überleben	n.
lemrey	überlebend, überlebt	adj.
nemrey	in einer Weise, als wäre das Leben in Gefahr	adv.,intj.
wawe	Bedeutung, Wichtigkeit, Signifikanz	n.
txanwawe	emotional bedeutungsvoll, bedeuteund, signifikant	adj.
nìwawe	bedeutungsvoll, auf bedeutende Weise	adv.
keyrel	Gesichtsausdruck	n.
fwampop	Tapirus (Tapiähnliches Tier auf Pandora)	n.
säplltxe	Aussage, Stellungnahme, Bericht, Statement	n.
säplltxevi	Kommentar, Bemerkung, Anmerkung	n.
kawtseng	nirgends, nirgendwo	adv.
tsapo	jener (nur für Personen)	pn.
fwefwi	pfeifen	vin.
'etnaw	Schulter	n.
pllngay	zugeben, eingestehen	vin.
kawngsar	ausbeuten	vtr.
lom	vermisst, fehlend (wie eine abwesende Person, nach der man sich sehnt)	adj.
koaktan	alter Mann	n.
koakte	alte Frau	n.
koaktu	alte Person	n.
lomtu	vermisste/fehlende Person	n.
fe'	schlecht	adj.
nìfe'	in schlechter Weise, schlecht	adv.
wätu	Gegner	n.
fekem	Unfall	n.
hawtsyìp	Schläfchen, Nickerchen	n.
uran	Boot	n.
ftxozä si	feiern	vin.
kekem	nichts (keine Handlung)	pn., adv.
pxen	(funktionale) Kleidung; Kleidungsstück	n.
tewng	Lendenschurz	n.
raspu'	Leggins (Kriegskleidung)	n.
hawnven	Schuh	n.
hawntsyokx	Handschuh	n.
hawre'	Hut, Kopfbedeckung	n.
ioi	zeremonielle Kleidung, Schmuck, Verzierung	n.
nìlun	natürlich, logischerweise	adv.
'ali'ä	Halskette, Halsband, Halsreif	n.
'are	Umhang, Poncho	n.
fkxile	Halskette, die den gesamten Oberkörper bedeckt	n.
masat	Brustpanzer, Harnisch	n.
nikroi	Haarschmuck	n.
pxawpxun	Armband	n.
renten	Brille (aus Insektenflügeln, geschnitztes Holz, etc.)	n.
tsamopin	Kriegsbemalung	n.
tsang	Piercing	n.
miktsang	Ohrring	n.
ontsang	Nasenring	n.
yemstokx	anziehen, aufsetzen, anlegen (Kleidung)	vtr.
ioi si	schmücken, verzieren (mit zeremonieller Kleidung)	vin.
'aku	ausziehen; entfernen, wegmachen, wegnehmen, abhauen	vtr.
le'aw	einzige, r, s	adj.
mawkrra	nach (zeitlich)	conj.
akrrmaw	nach (zeitlich)	conj.
Toitslan	Deutschland	prop.n.
Toitsye	Deutsch (Sprache); deutsch	adj.
lukpen	ohne Kleidung, nackt	adj.
fmawnta	Neuigkeit, die XYZ (indirekte FrageKonstruktion)	n.
vin	anfragen, erbitten, bitten	vtr.
mìftxele	übrigens, was dieses Thema betrifft	adv.
zìma'uyu	Neuling, Neuankömmling, jemand, der gerade angekommen ist	n.
nìvingkap	übrigens (neues Thema einleitend)	adv.
txankrr	lange Zeit, lang	adv.
vingkap	in den Sinn kommen, einfallen	vtr.
tìomum	Wissen	n.
tinan	Lesen	n.
ninan	durch Lesen, in lesender Weise	adv.
tsmìm	Spur, Fährte (von Tieren oder Menschen)	n.
inan	lesen (z.B. den Wald), Wissen durch sinnliche Eindrücke erlangen	vtr.
'ä'	huch! hoppla! upps!	intj.
teynga	dass (indirekte FrageKonstruktion)	n.
teyngla	dass (indirekte FrageKonstruktion im Agens)	n.
teyngta	dass (indirekte FrageKonstruktion im Patiens)	n.
fayluta	diese Wörter, dass (indirekte FrageKonstruktion im Patiens)	n.
stxenu	Angebot	n.
tìtstew	Mut, Tapferkeit, Courage	n.
tìtstewnga'	mutig, beherzt, tapfer	adj.
stxenutìng	anbieten	vtr.
tsyär	ablehnen, abweisen, zurückweisen	vtr.
tìtsyär	Ablehnung, Zurückweisung	n.
mll'an	akzeptieren, annehmen	vtr.
tìmll'an	Akzeptanz	n.
kam	vor (zeitlich, Zeitpunkt)	adp.
kay	in (zeitlich)	adp.
'awnìm	meiden, vermeiden, jdn/et umgehen	vtr.
steng	ähnlich	adj.
nìsteng	ähnlich, in ähnlicher Weise	adv.
nim	scheu, schüchtern	adj.
srätx	nerven, belästigen, stören	vtr.
säsrätx	Belästigung, Störung	n.
rì'ìr	Reflexion, Spiegelung	n.
rì'ìr si	reflektieren, imitieren, nachmachen, nachahmen	vin.
tsìsyì	flüstern	vin.
nìwok	laut, in lauter Weise	adv.
sätsìsyì	Geflüster, Flüstern	n.
nìtsìsyì	mit einem Flüstern, flüsternderweise	adv.
nìfwefwi	pfeifenderweise, pfeifend	adv.
lawr	Melodie	n.
tìng lawr	wortlos singen, eine Melodie wiedergeben	vin.
säomum	Information	n.
kosman	wunderbar, fantastisch, toll	adj.
nìksman	wunderbarerweise, fantastischerweise, tollerweise	adv.
letsim	ursprünglich, einzigartig, nicht von einem anderen Ursprung hergeleitet	adj.
lesngä'i	ursprunglich, Ursprungs, Original, Ur, erstes in einer Reihe	adj.
nìtsim	ursprünglich, in ursprünglicher Weise	adv.
nìsngä'i	anfangs	adv.
ngong	träge, teilnahmslos, lethargisch; faul	adj.
walak	aktiv, lebhaft, dynamisch, energiegeladen	adj.
tìngong	Trägheit, Teilnahmslosigkeit, Lethargie	n.
txi	Hast, Hetze, Raserei	n.
letxi	hastig, eilig, überstürzt	adj.
nìtxi	in hastiger Weise	adv.
letxiluke	gemächlich, gemütlich	adj.
nìtxiluke	in gemächlicher, gemütlicher Weise	adv.
kulat	hervorbringen, offenbaren, enthüllen, aufdecken (wörtlich und übertragen)	vtr.
txantompa	Regenguss, Regenschauer	n.
meyam	umarmen, in den Armen halten	vtr.
sämyam	Umarmung	n.
fìtsap	einander, gegenseitig	adv.
nuä	jenseits, (weit) hinter	adp.
kanfpìl	konzentrieren, Aufmerksamkeit richten auf	vin.
fmokx	Neid, Eifersucht (neutral)	n.
nìfmokx	in neidischer, eifersüchtiger Weise	adv.
kìmar	in Saison, Saison haben (für Nahrung, Gemüse und Tiere); für Tiere: rollig, läufig	adj.
nìkmar	günstig, rechtzeitig, passend	adv.
nìngong	in träger, fauler, lethargischer Weise	adv.
säpom	Kuss	n.
kxukx	schlucken, verschlucken	vtr.
txewm	angsteinflößend, beängstigend, erschreckend	adj.
hìmpxì	Minderheit, kleiner Teil	n.
kawnglan	bösartig, böshaft	adj.
nutx	dick	adj.
flì	dünn	adj.
flìnutx	Dicke, Schichtdicke	n.
sneyä	sein, ihr eigene, r, s	pn.
säsyep	Falle	n.
yora'tu	Gewinner	n.
snaytu	Verlierer	n.
way a plltxe	gesprochenes Gedicht (i.S. melodische Rezitation)	ph.
way a rol	gesungenes Gedicht	ph.
wayä aylì'u	Gedichttext, Liedtext	ph.
ultxatu	Teilnehmer eines Treffens	n.
wo	greifen nach, erreichen wollen	vtr.
yawo	abheben, starten	vin.
tsìk	plötzlich, ohne Vorwarnung	adv.
kllwo	landen (Vorgang), niedersinken, herabsinken	vin.
kllpä	landen, aufkommen, aufsetzen	vin.
sätswayon	Flug (Vorgang des Fliegens)	n.
rawn	ersetzen, austauschen, wechseln	vtr.
tìrawn	Ersetzen, Austausch; Ablösung	n.
särawn	Ersatz, Ausgetauschtes	n.
kxeltek	aufheben, hochheben, anheben	vtr.
fngo'	fordern, erfordern, verlangen	vtr.
säfngo'	Aufforderung, Forderung	n.
ngam	Echo	n.
slär	Höhle	n.
ngampam	Reim	n.
ngampam si	reimen	vin.
faoi	weich, glatt, sanft, geschmeidig	adj.
ekxtxu	rau, grob, spröde	adj.
yo'	perfekt, makellos, fehlerfrei sein	svin.
nìyo'	in perfekter, makelloser, fehlerfreier Weise	adv.
nìyol	kurz (Zeit), in kurzer Weise	adv.
tìyo'	Perfektion	n.
'ipu	lustig, witzig, humorvoll, amüsant, komisch	adj.
tì'ipu	Humor, Komik	n.
tìfmi	Versuch	n.
sä'ipu	etwas Lustiges, Komisches	n.
hangvur	Witz, lustige Geschichte	n.
lì'uvan	Wortwitz, Wortspiel	n.
kanom	erhalten, bekommen	vtr.
säkanom	etwas Erhaltenes, Bekommenes	n.
srìn	zeitweise von etwas zu etwas anderem übertragen (selten ohne Präfixe benutzt)	vtr.
käsrìn	leihen, verleihen, verborgen	vtr.
zasrìn	borgen, ausborgen, ausleihen	vtr.
säsrìn	etwas Geliehenes, Geborgtes	n.
pxìmun'i	teilen, trennen, entzweien	vtr.
lätxayn	(im Kampf) besiegen, überwältigen, erobern, bezwingen	vtr.
sälätxayn	Niederlage, Sieg (über jemanden)	n.
yll	gemeinschaftlich, kommunal, Gemeinde	adj.
nìyll	in gemeinschaftlicher Weise	adv.
hona	liebenswert, reizend, niedlich	adj.
tìhona	Niedlichkeit, Liebenswertheit	n.
fäkä	hinaufgehen, aufsteigen, hochsteigen	vin.
fäza'u	hinaufkommen, heraufkommen	vin.
kllza'u	hinunterkommen, herunterkommen	vin.
sämok	Vorschlag	n.
mal	glaubhaft, vertrauenswürdig	adj.
nìmal	glaubhaft, ohne Zögern	adv.
tìmal	Glaubhaftigkeit, Vertrauenswürdigkeit	n.
kllyem	vergraben, beerdigen	vtr.
nìtsyìl	durch klettern, durch erklimmen, in kletternder Weise	adv.
sätsyìl	Klettern, Erklimmen	n.
rìn	Holz	n.
flawkx	Leder	n.
'ana	Liane, Kletterpflanze	n.
tsngawpay	Tränen	n.
tsngawpayvi	Träne	n.
nìhona	auf liebenswerte, niedliche Weise	adv.
lepay	wässrig, durchtränkt	adj.
'ul	ansteigen, vermehren, erhöhen, steigern	vin.
nän	abnehmen, vermindern, sinken, abfallen	vin.
nìnän	wenig, in weniger Weise, in geringer Weise	adv.
nì'ul'ul	ansteigend, mehr und mehr	adv.
nìnänän	abnehmend, weniger und weniger	adv.
mek	leer; fig.: wertlos, gedankenlos, unsinnig	adj.
leioae	Respekt	n.
leioae si	respektieren	vin.
säwìntxu	Ausstellung, Vorführung, Schau	n.
tì'i'a	Ende, Abschluss	n.
srer	auftauchen, erscheinen, in Sicht kommen	vin.
'ìp	verschwinden, aus der Sicht verschwinden	vin.
tsong	Tal	n.
tsongtsyìp	Grübchen	n.
ro'a	beeindrucken, imponieren, Ehrfurcht und Respekt erwecken	vin.
säro'a	große Tat, Leistung	n.
säro'a si	große Taten vollbringen	vin.
txanro'a	berühmt sein	vin.
velek	aufgeben, ergeben, Niederlage eingestehen	vin.
spono	Insel	n.
txew	Rand, Kante, Grenze, Ende, Limit	n.
txewnga'	endliche, r, s, begrenzt, ein Ende haben	adj.
litx	scharf (z.B. Klinge)	adj.
fwem	stumpf, abgerundet, abgenutzt (z.B. Spitze)	adj.
syura	Energie (physisch oder spirituell)	n.
syuratan	Biolumineszenz	n.
txonkrr	nachts, des Nachts, bei Nacht	adv.
yuey	schön (innere Schönheit)	adj.
kxem	vertikal sein, senkrecht sein	vin.
txay	horizontal sein, waagerecht sein	vin.
nìkxem	in vertikaler Weise	adv.
nìtxay	in horizontaler Weise	adv.
klltxay	(auf dem Boden) liegen	vin.
klltxeykay	(hin)legen (auf den Boden)	vtr.
yo	Oberfläche	n.
kxemyo	Wand, vertikale Oberfläche	n.
fyep	(in der Hand) halten, fassen	vtr.
nìk'ärìp	fest, kontinuierlich	adv.
nìklonu	fest, unerschütterlich	adv.
nìktungzup	sorgfältig, fest, bestimmt	adv.
nìsyep	eisern fest(halten)	adv.
nìmeyp	schwach, schwächlich, locker	adv.
säfyep	Griff	n.
slan	unterstützen (emotional, sozial oder persönlich)	vtr.
tìslan	Unterstützung (emotional, sozial oder persönlich)	n.
tìeyktan	Führung, Anführerschaft	n.
'llngo	Hüfte	n.
zare'	Stirn	n.
flawm	Wange	n.
prrku	Schoß, Unterleib, Mutterleib	n.
ngep	Bauchnabel, Nabel	n.
tawsyuratan	Aurora, Polarlicht	n.
syeha	Atem	n.
syeha si	atmen	vin.
sko	(etwas, jemand) als (etwas, jemand anderes), in der Rolle als, in der Eigenschaft als	adp.
sna'o	Satz (von Objekten), Gruppe, Haufen, Klumpen, Bestand (von Bäumen)	n.
snatxärem	Skelett	n.
snafpìlfya	Philosophie	n.
snatanhì	Konstellation, Sternkonstellation	n.
sästarsìm	Zusammenstellung, Sammlung (gewollt von einer Person)	n.
tsu'o	Fähigkeit, Können	n.
krra	wenn; zu der Zeit, als	conj.
snatanhìtsyìp	Sternenhaufen	n.
pìwopxtsyìp	Nebel(wolke)	n.
tìterkup	Sterben, Tod (abstrakt)	n.
maweypeyyu	geduldige Person	n.
ftxulì'u	eine Rede halten	vin.
ftxulì'uyu	Redner, (öffentlicher) Sprecher	n.
säftxulì'u	Rede, Ansprache	n.
tìftxulì'u	öffentliches Reden	n.
slantire	Inspiration, Eingebung	n.
slantire si	inspirieren, begeistern, anregen	vin.
kum	Ergebnis, Resultat	n.
kuma	dass (als Ergebnis), sodass	conj.
akum	dass (als Ergebnis, sodass	conj.
fyel	versiegeln, verschließen, abdichten, undurchlässig machen	vtr.
zey	besonders, speziell	adj.
vll	hinweisen, (auf etwas) zeigen, weisen, hindeuten	vin., vtr.
eykyu	Anführer (meist einer kleinen Gruppe oder Jägertrupp)	n.
am'ake	selbstbewusst, selbstsicher, zuversichtlich	adj.
nam'ake	zuversichtlich, in selbstsicherer/selbstbewusster Weise	adv.
kezemplltxe	unnötig zu erwähnen, dass...; natürlich, selbstverständlich	adv.
tare	verbinden, in Beziehung stehen, eine Beziehung haben	vtr.
nìsoaia	(zusammen) als Familienmitglied	adv.
nìolo'	(zusammen) als Clanmitglied	adv.
sätare	Verbindung, Verwandtschaft, Beziehung, Verhältnis	n.
sloa	breit, weit, umfangreich	adj.
snep	schmal, eng	adj.
slosnep	Weite, Breite	n.
peslosnep	wie breit?	inter.
slosneppe	wie breit?	inter.
hoet	gewaltig, enorm, riesig, ausgedehnt	adj.
nìhoet	(weit) verbreitet, in ausgedehnter Weise	adv.
so'ha	begeistert sein von, Begeisterung zeigen	vtr.
tìso'ha	Begeisterung, Enthusiasmus, eine gute Einstellung haben	n.
nìso'ha	auf begeisterte, enthusiastische Weise	adv.
leso'ha	begeisterungsfähig, eifrig	adj.
tsawlultxa	große Versammlung, Konferenz	n.
zìsìtay	nächstes Jahr	n.
tìtsunslu	Möglichkeit	n.
numultxa	Klasse, Schulklasse, Lerngruppe	n.
numultxatu	Klassenkamerad, Teilnehmer einer Klasse/Lerngruppe	n.
snanumultxa	Kurs, Lehrveranstaltung	n.
tìflä	das Erfolghaben (allgemein)	n.
säflä	Erfolg	n.
mesrram	Tag vor zwei Tagen, vorgestern	n., adv.
mesrray	Tag nach morgen, übermorgen	n., adv.
pxesrram	vor drei Tagen	n., adv.
pxesrray	in drei Tagen	n., adv.
mong	verlassen auf, angewiesen sein auf, auf Schutz vertrauen	vtr.
sru'	zerdrücken, zerquetschen, niedertrampeln	vtr.
'ekxin	eng, straff, eng anliegend	adj.
um	locker, lose, weit (für Kleidung)	adj.
'ekxinum	Grad von Straffheit, Lockerheit	n.
pekxinum	wie eng, locker?	inter.
zeswa	Gras	n.
zeswavi	Grashalm	n.
lezeswa	grasbedeckt, grasig, Gras	adj.
lopx	in Panik geraten, in Panik verfallen	vin.
hifwo	fliehen, flüchten, Flucht ergreifen, entkommen	vin.
yrrap	Sturm, Unwetter, Gewitter	n.
'rrpxom	Donner	n.
rawm	Blitzen (allgemein)	n.
rawmpxom	Blitz und Donner	n.
se'ayl	einzelner hoher, dünner Wasserfall, der sich von einer hohen Klippe oder einem Schwebenden Berg ergießt (zählbar)	n.
kxor	eine Wand oder Ufer von mächtigen Fällen, auffallend durch ihr ohrenbetäubendes Tosen und ihre tödliche Kraft (zählbar, aber selten)	n.
syanan	eine einzelne Fallhöhe oder Folge von kleineren Fällen, die nacheinander in einem Strom oder in einer Reihe von Becken auftreten (zählbar)	n.
rurur	luftdurchsetztes Wasser, das zwischen Steinen eines sehr allmählich abfallenden Stroms fließt (nicht zählbar)	n.
tseltsul	Wildwasserstrom, Stromschnellen (zählbar, aber selten)	n.
tìmeyp	Schwäche	n.
am'aluke	zweifelsohne	adv.
atanzaw	Blitz, gegabelter Blitz	n.
nìsìlpey	hoffentlich	adv.
talun	wegen, aufgrund von	adp.
nìTsyungwen	Zhongwen	adv.
reykol	musizieren, veranlassen zu singen (poetisch)	vtr.
nrra	Stolz, Gefühl von Stolz	n.
lenrra	stolz, Gefühl von Stolz (für andere)	adj.
nìnrra	mit Stolz, in stolzer Weise	adv.
snonrra	Arroganz, Hochmut, SelbstStolz	n.
lesnonrra	arrogant, hochmütig, voll von SelbstStolz	adj.
nrr	glühen, leuchten, glimmen	vin.
ylltxep	kommunales Feuer, Feuerstelle (an der die Na’vi gemeinsam essen)	n.
txeptseng	Feuerstelle (allgemein), Stelle, an der ein Feuer brennt oder brannte	n.
ralnga'	sinnvoll, lehrreich, aufschlussreich; etwas, von dem eine Lehre gezogen werden kann	adj.
munsna	Paar (von etwas)	n.
fyin	simpel, einfach, leicht	adj.
ep'ang	komplex, kompliziert	adj.
epxang	Steinkrug, Steingefäß, um giftige Spinnentiere aufzubewahren	n.
fyinep'ang	Komplexität, Grad an Komplexität	n.
pefyinep'ang	wie kompliziert?	inter.
fyinep'angpe	wie kompliziert?	inter.
sngä'itseng	Anfang, Startposition, Anfangspunkt	n.
srungsiyu	Helfer, Gehilfe, Assistent	n.
srungtsyìp	hilfreicher Hinweis, Tipp	n.
spulmokri	Telefon	n.
syeprel	Kamera	n.
swoa	berauschendes Getränk, ``Spirituosen''	n.
rou	betrunken sein, sich betrinken	vin.
pamrelvi	Buchstabe (phonetisches Symbol)	n.
snapamrelvi	Alphabet	n.
tìtxen si	aufwecken, wecken, erwecken	vin.
fnetxum	Allergen	n.
zet	behandeln als, behandeln wie, eine Einstellung zu etwas zeigen	vtr.
ha'	(zusammen) passen, übereinstimmen, ergänzen, grundsätzlich verbessern	vin.
syon	Merkmal, Eigenschaft, Eigenart, Besonderheit, Kennzeichen, Attribut, Charakterzug, Aspekt, Facette	n.
ran	wesentliche Charakteristik, innewohnende Charakteristik, Essenz, Konstitution; für Personen ``Persönlichkeit, Individualität"	n.
fyole	außergewöhnlich, grandios, unvergleichlich, ehrfurchtgebietend, jenseits von Perfektion	adj.
loran	Eleganz, Grazie, Anmut, Liebreiz	n.
fe'ran	fehlerhafte Charakteristik, etwas schlecht Durchdachtes, etwas grundsätzlich Fehlerhaftes	n.
reyfya	Lebensweise, Kultur	n.
fe'ranvi	Schönheitsfehler, Makel, Defekt, Mangel, Unförmigkeit, fehlerhafte Eigenschaft	n.
nìran	grundsätzlich, prinzipiell, im Grunde, im Kern, im Wesentlichen	adv.
mo	Raum, Hohlraum, begrenzter Bereich	n.
snomo	Raum (als Rückzugsmöglichkeit)	n.
wum	ungefähr, etwa, circa, schätzungweise, annähernd	adv.
kesran	mittelmäßig, medioker, solala	adj.
nìksran	in mittelmäßiger Weise	adv.
yewla	Enttäuschung, fehlerhafte Erwartung, Gefühl von ImStichgelassenwerden	n.
leyewla	enttäuschend	adj.
nìyewla	in enttäuschender Weise, den Erwartungen nicht gerecht entsprechend	adv.
yawnyewla	gebrochenes Herz, Herzschmerz	n.
ve'o	Ordnung (im Gegensatz zu Chaos oder Unordnung)	n.
vezo	ordentlich sein, organisiert sein, aufgeräumt sein	vin.
vezeyko	ordnen, ordentlich machen, aufräumen, in Ordnung bringen	vtr.
vefya	Methode, Herangehensweise, System, Prozedere, Prozess	n.
velke	chaotisch, unordentlich, durcheinander, unaufgeräumt	adj.
venga'	organisiert, ``alles im Griff haben", ``den Überblick behalten"	adj.
nìfnu	in leiser Weise, in stiller Weise	adv.
sätaron	Jagd (konrektes Ereignis)	n.
wäsul	konkurrieren, sich messen, wetteifern, wettstreiten	vin.
tìwäsul	Wettstreit, Konkurrenz (abstrakt)	n.
säwäsul	Wettkampf, Konkurrenz (konkret)	n.
säwäsultsyìp	Wettbewerb	n.
tìmwiä	Gerechtigkeit, Fairness	n.
snew	einengen, einschnüren, verengen, straffen, zuziehen, zusammenziehen	vtr.
txantxew	Maximum, Höchstmaß	n.
snewsye	gruselig, schaurig, schauerlich, schreckhaft, unheimlich	adj.
hìmtxew	Minimum, Mindestmaß	n.
txantxewvay	maximal, höchstens	adv.
hìmtxewvay	minimal, mindestens	adv.
hefi	riechen (ungewollt)	vtr.
ewku	schmecken (ungewollt)	vtr.
zìm	fühlen (ungewollt)	vtr.
yune	zuhören, hinhören, anhören	vtr.
syam	riechen (gewollt)	vtr.
'ur	Aussehen, Erscheinungsbild, Anblick	n.
sur	Geschmack, Aroma, Geschmacksrichtung	n.
zir	Berührung, Gefühl, Beschaffenheit, Textur	n.
tse'atswo	Sehvermögen, Sehsinn	n.
stawmtswo	Gehörsinn, Hörvermögen	n.
hefitswo	Geruchsinn, Geruchvermögen	n.
ewktswo	Geschmacksinn	n.
zìmtswo	Tastsinn, Tastvermögen	n.
fkan	einer sinnlichen Weise ähneln, den Sinnen erscheinen als ob	vin.
onlor	gutriechend	adj.
onvä'	schlechtriechend	adj.
we'ay	sauer	adj.
wip	salzig	adj.
fwang	herzhaft, pikant, umami, reichhaltig	adj.
nget	nasskalt, modrig, Geruch von verrotenden Blättern und Holz	adj.
kxänäng	faulig, verwest, verdorben, Geruch von verfaulendem Tier(fleisch)	adj.
sosul	angenehmer Geruch von nahem Gewässer, Regen, feuchter Vegetation	adj.
unyor	süßlicharomatisch (blumig oder aromatisch holziger Geruch; kann sich auch auf ein Gewürz in der Na'vi Küche beziehen)	adj.
atxar	Geruch von lebenden Tieren, wie er sich um ein Wasserloch oder ein Gelege findet	adj.
inanfya	Sinn, sinnlicher Eindruck, Wahrnehmung	n.
uvan letokx	physisches oder athletisches Spiel, Sport	n.
ftärpa	linke Seite	n.
skiempa	rechte Seite	n.
rengop	entwerfen, designen, gestalten (im Detail)	vtr.
tìrengop	Entwerfen, Designen, Gestalten	n.
särengop	Design, Entwurf	n.
ingyen	Gefühl von Unverständnis, Rätselhaftigkeit, Nichtverstehen	n.
sngumtsim	Grund, Ursache von Besorgnis	n.
yayayrtsim	Grund, Ursache von Verwirrung	n.
ingyentsim	Mysterium, Rätsel	n.
ingyentsyìp	Trick, Kniff, klevere oder spezielle Methode	n.
ningyen	in mysteriöser, rätselhafter Weise	adv.
ingyenga'	mysteriös, rätselhaft	adj.
sngunga'	besorgniserregend, beunruhigend	adj.
yayayrnga'	verwirrend	adj.
yrr	wild, natürlich, naturbelassen (etwas in unverändertem, natürlichem Zustand)	adj.
nìyrr	in natürlicher Weise, ohne den natürlichen Zustand zu ändern	adv.
zäfi	verändert, nicht länger in natürlichem Zustand	adj.
syor	entspannen, relaxen, chillen	vin.
tìsyor	Entspannung	n.
tìfnunga'	ruhig	adj.
späpeng	sich wiederherstellen (metaphorisch), mit sich selbst ins Reine kommen	vin.
'anla	sehnen nach, verzehren nach, schmachten	vtr.
sä'anla	Sehnen, Verzehren, Schmachten	n.
lie	Erlebnis	n.
tsìlpey	Hoffnung (abstrakt)	n.
säsìlpey	Hoffnung (konkret)	n.
kelsar	unbrauchbar, nutzlos, vergeblich	adj.
yì	Ablage, Felsvorsprung, Sims, Ebene, Stufe, Sprosse	n.
snayì	Treppen, Treppenstufen, Reihe von Stufen ähnlichen Ebenen	n.
kxaylyì	hohe(r, s) Ebene, Stand, Niveau	n.
kxamyì	mittlere(r, s) Ebene, Stand, Niveau	n.
tìmyì	niedrige(r, s) Ebene, Stand, Niveau	n.
flrr	zart, mild, zanftmütig, zärtlich, einfühlsam, behutsam (Lebewesen oder Dinge)	adj.
nìflrr	in zarter, milder, sanftmütiger Weise	adv.
tìflrr	Zärtlichkeit, Milde, Sanftheit, Zartheit	n.
ngä'än	(mental, emotional) leiden, elend sein, unglücklich sein	vin.
kelkin	unnötig, überflüssig, nicht erforderlich	adj.
nìkelkin	in unnötiger, überflüssiger, nicht erforderlicher Weise	adv.
sängä'än	Anfall von Leiden, kurze Depression	n.
'eylanay	Bekannter, Bekannte (Möglichkeit zu Freundschaft)	n.
eyktanay	Stellvertreter, General (in der Rangfolge unter dem Anführer)	n.
tsulfätunay	BeinahMeister, Lehrling (zum Meister)	n.
karyunay	Lehrling (zum Lehrer), Referendar	n.
tsan'ul	(sich) verbessern, besser werden	vin.
fe'ul	(sich) verschlechtern, schlechter werden	vin.
tìtsan'ul	Verbesserung (allgemein oder abstrakt)	n.
tìfe'ul	Verschlechterung (allgemein oder abstrakt)	n.
sätsan'ul	Verbesserung (konkreter Fall)	n.
säfe'ul	Verschlechterung (konkreter Fall)	n.
frafya	in jeder Hinsicht	adv.
postì	Forum/Blogbeitrag	n.
ketsran	egal (wer, was, wie, wo), gleichgültig	adj.,  conj.
kangay si	bestätigen, bestärken, für gültig erklären	vin.
txurtel	Seil	n.
ropx	Loch (durchgängig durch ein Objekt)	n.
tsongropx	Loch, Aushöhlung mit einem Boden (sichtbar oder angenommen)	n.
tsrul	Nest, Nistplatz, Bau, Lager (Lagerstätte für Pandoras Fauna)	n.
yayotsrul	Vogelnest	n.
lini	Junges (von Säugetieren, Vögeln, Fischen, Insekten), Jungtier	n.
tarnioang	Raubtier, Jäger	n.
rong	Tunnel	n.
swek	Stange, Stab, Pfosten, Pfahl	n.
mektseng	Lücke, Spalt	n.
tsenga	wo; Ort, wo	conj.
fta	Knoten	n.
fta si	knoten, knüpfen, einen Knoten machen	vin.
fwi	schlittern, rutschen	vin.
oìsss si	fauchen	vin.
il	biegen, beugen, neigen	vin.
kxakx	zerbrechen, kaputt gehen	vin.
ftumfa	heraus, von innen nach außen	adp.
sä'eoio	Zeremonie, Ritual, Brauch	n.
sä'eoio si	einer Zeremonie beiwohnen, ein Ritual begehen	vin.
kur	hängen, aufhängen, anhängen	vin.
nìtkan	absichtlich, gezielt, mit Absicht	adv.
nìtkanluke	versehentlich, unbeabsichtigt, unabsichtlich	adv.
nui	fehlschlagen, scheitern, Misserfolg haben, fehlgehen, nicht das gewünschte Ergebnis erlangen	vin.
nìnu	fehlgeschlagen, nutzlos, nicht das gewünschte Ergebnis erlangend	adv.
tìnui	Fehlschlagen, Versagen, Scheitern (abstrakter Sinn)	n.
sänui	Fehlschlag, Misserfolg, Versagen	n.
fngä'	sich erleichtern, austreten, Notdurft verrichten; (auf der Erde:) auf die Toilette gehen	vin.
zun	wenn (für irreale Bedingungssätze)	conj.
zel	dann (für irreale Folgesätze)	adv.
'ekxinumpe	wie eng, locker?	inter.
okup	Milch	n.
loi	Ei	n.
tsyeym	Schatz, Kostbarkeit, etwas seltenes von Bedeutung und großem Wert	n.
wokau	Pendeltrommel	n.
srä	Stoff; an einem Webstuhl hergestelltes Stück Stoff	n.
srok	Perle (dekorativ)	n.
pxayopin	bunt, farbenfroh	adj.
tsyoklìt	Schokolade	n.
paynäpll	Ananas	n.
pamrelsiyu	Schreiber, Autor	n.
rel arusikx	Film, Video, Spielfilm	n.
lì'upuk	Wörterbuch	n.
lì'upuk	Wörterbuch	n.
nìkemweypey	in ungeduldiger Weise	adv.
kelemweypey	ungeduldig	adj.
'on	Form	n.
salewfya	Richtung, Kurs	n.
koum	abgerunded, gekrümmt	adj.
ko'on	Kreis, Oval, Kreisring, geschlossene beinah kreisrunde Form	n.
yo'ko	Kreis, perfekte Kreisform	n.
renulke	irregulär, willkürlich	adj.
vawt	fest, massiv, nicht hohl	adj.
momek	hohl, nicht fest	adj.
yeyfya	gerade Linie	n.
yak	Gabelung, Abzweigung, Verzweigung; Punkt, von dem aus etwas auseinander geht	n.
yak si	abbiegen, auseinandergehen, Richtung ändern, sich verirren, verlaufen, vom Weg abkommen	vin.
nìyeyfya	geradeaus, in gerader Linie	adv.
nìftär	nach links, zur Linken, linker Hand	adv.
nìskien	nach rechts, zur Rechten, rechter Hand	adv.
'oratsyìp	Teich, Tümpel, Weiher	n.
nìyawr	korrekt, richtig; in korrekter, richtiger Weise	adv.
tìsteftxaw	Untersuchung, Überprüfung	n.
yoa	im Austausch für	adp.
txolar	Dollar (Währung)	n.
ewro	Euro (Währung)	n.
lawnol	große Freude	n.
ley	kostbar sein, einen positiven Wert haben, etwas wert sein, wertschätzen	vin.
säfmi	Versuch, Bemühung, Bestreben	n.
nìfkeytongay	tatsächlich, in der Tat, in Wahrheit	adv.
mowar	Rat, Ratschlag	n.
mowar si	beraten, Ratschlag geben	vin.
mowarsiyu	Berater, Ratgeber	n.
kakpam	taub	adj.
tìkakpam	Taubheit	n.
pxek	treten, schubsen	vtr.
kolan	ich meine, eher (Selbstverbesserung)	intj.
hena	tragen	vtr.
sähena	Behälter, Gefäß, Behältnis	n.
paysena	Wasserbehälter	n.
tutsena	Trage, Liege	n.
tstalsena	Messerscheide	n.
swizawsena	Köcher (am Ikransattel befestigt)	n.
tìkakrel	Blindheit	n.
ngoa	Schlamm, Schlick, Matsch	n.
mawfwa	nach(dem)	conj.
neni	Sand	n.
fwep	Staub (auf einer Oberfläche)	n.
fwopx	Staub (in der Luft), Staubwolke	n.
nìyey	direkt, sofort, unmittelbar, geradenwegs, ohne Unweg/Umschweife, auf direkte Weise; einfach	adv.
'al	verschwenden, vergeuden, (unnütz) verbrauchen	vtr.
tì'al	Verschwendung	n.
le'al	verschwenderisch	adj.
nì'al	verschwenderisch, in verschwenderischer Weise	adv.
srey	Version, Fassung, Variante	n.
lupra	Stil, Stilrichtung, Duktus	n.
fyolup	exquisit, auserlesen, vorzüglich, großartig im Stil	adj.
fe'lup	geschmacklos, kitschig, billig, schlechter Stil/Geschmack	adj.
snolup	persönlicher Stil oder Ästhetik, Präsenz, Ausstrahlung	n.
'ongop	entwerfen, entwickeln, gestalten (von größeren, groberen Aspekten)	vtr.
'ongopyu	Designer	n.
uniltìrantokxolo'	Clan oder Gruppe von Avatars	n.
krrka	während	adp.
tìreyn	Zug, Eisenbahn, Bahn	n.
LosÄntsyelesì	Los Angeles	pn.
tson	Verpflichtung, Pflicht, auferlegte Anforderung	n.
nìtson	in pflichtbewusster Weise, als eine Verpflichtung	adv.
kxìm	befehlen, anordnen, verlangen, anweisen, auftragen, eine Aufgabe zuweisen	vtr.
tsonta	(etwas) zu machen (mit kxìm)	conj.
tìkxìm	Befehlen, Befehligen, Auftragserteilung	n.
tìkxìm si	in der Rangfolge über jemandem sein, jemandes Vorgesetzter sein	vin.
kxìmyu	Befehlshaber, Vorgesetzter, Kommandant	n.
saylahe	et cetera	adv.
fpomron	(mentalle) Gesundheit oder Wohlsein	n.
lefpomron	(mental) gesund	adj.
kelfpomron	(mental) ungesund	adj.
fpomtokxnga'	(physisch) heilsam	adj.
kefpomtokxnga'	(physisch) unheilsam	adj.
fpomronga'	(mental) heilsam	adj.
kefpomronga'	(mental) unheilsam	adj.
srefpìl	annehmen	vtr.
srefwa	vor, bevor	conj.
ken'aw	nicht nur	adv.
släkop	sondern auch	adv.
sngum si	sorgen, sich sorgen, beunruhigt sein	vin.
väpam	Lärm, schlimmes oder unangenehmes Geräusch, Kreischen	n.
hawmpam	Lärm, Geräusch, das zu stark, unnötig, unangebracht, unerwartet oder überraschend ist	n.
lehawmpam	laut, geräuschvoll, mit viel Lärm	adj.
nìhawmpam	lärmend, mit viel Lärm, in lärmender/lauter Weise	adv.
miklor	gutklingend, schönklingend	adj.
mikvä'	schlechtklingend	adj.
narlor	schönaussehend, visuell angenehm aussehend	adj.
narvä'	hässlich, unansehnlich	adj.
zawr	Tierruf, ein Tierschrei, der Ruf eines Tieres	n.
tìnew	Wunsch, Sehnsucht, Begierde, Verlangen	n.
nopx	wegtun, wegstecken, bei Seite legen, verstauen, ablegen	vtr.
tiam	zählen	vtr.
ketsuktiam	unzählbar, unendlich, endlos	adj.
txewluke	unendlich, grenzenlos, unbegrenzt	adj.
'umtsa	Medizin, Mittel	n.
lang	untersuchen, erforschen, forschen, erkunden, auskundschaften“	vtr.
tìlang	Erforschung, Entdeckungsfahrt	n.
sälang	eine Expedition oder Untersuchung	n.
kxum	dickflüssig, zähflüssig, gallertartig, gelartig, dick	adj.
kxumpay	dicke Flüssigkeit, zähflüssige Flüssigkeit, Gel	n.
sängop	Kreation, 	n.
tsyìl	erklimmen, klettern (mit Einsatz des ganzen Körpers)	vtr.
kxap	Bedrohung, Drohung	n.
kxapnga'	bedrohlich, drohend	adj.
nìkxap	bedrohlich, auf bedrohliche Weise	adv.
tìftiatu	Forscher	n.
tìftiatu kifkeyä	Wissenschaftler	n.
heyr	Brustkorb, Brust, Torso	n.
tseri	bemerken, auffallen	vtr.
kxap si	bedrohen, drohen	vin.
tìtseri	Wahrnehmen, Wahrnehmung, Beachtung, Beobachtung, Kenntnisnahme	n.
tìktseri	Nichtwahrnehmung, Nichtbeachtung, keine zur Kenntnisnahme	n.
yäkx	nicht beachten; ignorieren, jdn verächtlich abweisen, jdn. verächtlich/von oben herab behandeln	vtr.
tìyäkx	fehlende Beachtung, Ignorieren	n.
srunga'	hilfreich	adj.
säyäkx	Abweisung, Ignorieren	n.
ngip	Raum, Platz, offener oder grenzenloser Bereich	n.
txepram	Vulkan	n.
txekxumpay	Magma, Lava	n.
wrrza'u	herauskommen, hervortreten	vin.
tskxevi	Kieselstein, kleiner, von natürlichen Kräften geglätteter Stein	n.
nìkx	Schotter, Kies	n.
tìralpeng	Übersetzung, Interpretation	n.
unil si	träumen	vin.
uniltsa	etwas träumen, über/von etwas träumen, träumen (dass)	vtr.
mauti	Frucht	n.
utu	Blätterdach	n.
utumauti	Bananenfrucht	n.
slayk	kämmen, bürsten	vtr.
tìkelu	Mangel, Knappheit	n.
tompakel	Dürre, Trockenheit, Trockenperiode	n.
syuvekel	Hungersnot	n.
zawprrte'	angenehm sein, erfreulich sein, genießen, erfreuen an, Vergnügen finden an, Gefallen finden an	vin.
nawri	talentiert	adj.
tìnawri	Talent	n.
susyang	zerbrechlich, fragil, empfindlich	adj.
reym	Festland, trockenes Land (im Gegensatz zu Land mit Seen, Flüssen etc.)	n.
kop	sowohl ... als auch	conj.
tuvom	allergrößte, außerordentlich, äußerst	adj.
yengwal	Kummer, Leid, Trauer, Gram	n.
nip	feststecken, in etwas festhängen	vin.
hän	Netz (natürlich oder künstlich), Internet	n.
'rrko	rollen	vin.
tsngem	Muskel	n.
tsawsngem	muskulös	adj.
wìngay	beweisen	vtr.
tìwìngay	Beweisen, Beweisführung	n.
säwìngay	Beweis	n.
tìng zekwä	anfassen (gewollt)	vin.
weptseng	Webseite	n.
wep	das Web (d.h. world wide web)	n.
tseotu	Künstler (allgemeiner Begriff)	n.
tìkeftxo	Traurigkeit, Trauer	n.
tìkeftxonga'	traurig	adj.
pamtseongopyu	Musikmacher, Komponist	n.
lereyfya	kulturell	adj.
huru	Kochgefäß, Kochtopf	n.
sey	Becher, Schale, geringfügig aus natürlich vorkommenden Ressourcen geändert	n.
'e'in	Flaschenkürbis	n.
'e'insey	Kürbisflasche, Trinkbehälter	n.
sum	Muschel, Meeresmuschel	n.
sumsey	Trinkgefäß (aus Meeresmuscheln hergestellt)	n.
swoasey	(handgroße) KavaSchale (aus Samenhülsen hergestellt, genutzt, um berauschende Getränke zu trinken)	n.
swoasey ayll	große, kommunale KavaSchale	n.
tsyey	Snack, leichte Mahlzeit, Imbiss	n.
tsyeytsyìp	winziger Bissen, kleiner Happen	n.
nik	praktisch, geeignet, bequem, vorteilhaft; brauchbar, ohne viel Aufwand oder Anstrengung	adj.
niktsyey	Essenstasche, Wrap; Essen, das in essbare Blätter und Reben verpackt wurde	n.
merki	Erdgestell, Bodenrost (um Fleisch zu räuchern)	n.
ikut	großer Mörser, Stößel (Mahl und Reibewerkzeug)	n.
sämunge	Transportwerkzeug, Transportgerät	n.
syusmung	Ablage, Servierbrett, Tablett	n.
paysmung	Wasserbehälter, Wassertrage	n.
prrsmung	Babytrage, Babytragefell	n.
nivi	Hängematte zum Schlafen (allg. Begriff)	n.
swaynivi	Familienhängematte (zum Schlafen)	n.
snonivi	Hängematte für Einzelpersonen	n.
sänrr	Glühen, Leuchten, Glimmen; Lichtquelle, Lampe	n.
tsmi	Nektar	n.
tsmisnrr	Blasenlaterne, Nektarlaterne	n.
seyn	Stuhl, Sitz, Bank; jedes Hilfsmittel oder Vorrichtung, die Sitzen ermöglicht	n.
hoan	Gemütlichkeit, Komfort	n.
lehoan	gemütlich, heimisch	adj.
nìhoan	gemütlich, auf gemütliche Weise	adv.
kelhoan	ungemütlich	adj.
fyan	konstruiertes Gerät, um etwas vom Boden und sauber zu halten	n.
fyanyo	Tisch, erhöhte, zweckmäßige Oberfläche	n.
yomyo	Teller, Platte (für Essen)	n.
yomyo lerìk	Blattteller	n.
fyanyì	Ablage, Regal, Bord	n.
kurfyan	Korb, Tragekorb, hängende Ablage	n.
snokfyan	Ablage für persönliche Gegenstände	n.
kurfyavi	Haken (um etwas aufzuhängen)	n.
seyto	schlachten, (ein Tier) ausnehmen	vtr.
säseyto	Schlachtwerkzeug, Schlatermesser	n.
yaney	Kanu	n.
spulyaney	Kanupaddel	n.
lal	alt (Gegenteil von mip)	adj.
txanlal	uralt, sehr alt	adj.
tsankum	Vorteil, Nutzen, Gewinn	n.
tsankumnga'	vorteilhaft, von Vorteil	adj.
fekumnga'	unvorteilhaft, ungünstig, nicht von Vorteil	adj.
tìmungwrr	Ausnahme	n.
tìmungwrr si	eine Ausnahme machen	vin.
nawfwe	fließend (für das Sprechen)	adj.
fekum	Nachteil, Hindernis, Kehrseite, Schattenseite	n.
plltxeyu	Sprecher, Sprecherin	n.
pxawngip	Umwelt, Umgebung, Umfeld	n.
palulukantsyìp	Katze (Erdentier) wörtl. kleiner Thanator	n.
zum	Objekt, Ding, Sache (physisch und greifbar)	n.
hìpey	zögern, für kurze Zeit zurückhalten	vin.
tìhìpey	Zögern, Verzögerung	n.
snäm	verrotten, verwesen, (über einen Zeitraum) abbauen	vin.
kllrikx	Erdbeben	n.
sälatem	(ein Fall von) Veränderung, Änderung, Bearbeitung, Modifikation	n.
tìlatem	Veränderung (abstrakt)	n.
txatx	Blase, Bläschen	n.
lehìpey	zögerlich, im Zustand des Zögerns sein	adj.
nìhìpey	zögerlich, in zögernder Weise	adv.
ronguway	heulen	vin.
ronguwayyu	Heuler, ein Heulender	n.
ler	stetig, ruhig, sachte, gleichmäßig (für Bewegung)	adj.
nìler	in stetiger, ruhiger, gleichmäßiger Weise 	adv.
lo'a	Totem	n.
'ewrang	Webstuhl	n.
sa'ewrang	Mutterwebstuhl, Riesenwebstuhl	n.
tiretu	Schamane	n.
pasuk	Beere	n.
vozampasukut	Grinchbaum, Tausendbeerenbaum	n.
paskalin	süße Beere (Kosename, Kosewort)	n.
fngä'tseng	Toilette (auf der Erde), Toilettenbereich	n.
mo a fngä'	Toilette (auf der Erde)	n.
sa	sich einer Herausforderung stellen, einer Herausforderung gewachsen sein	vin.
tanleng	Rinde, Borke (eines Baumes)	n.
syokup	Gewicht (physisch)	n.
kewan	Alter (einer Person)	n.
tìnvi	Aufgabe, Auftrag, Schritt (in einer Anleitung)	n.
tìnvi si	eine Aufgabe, einen Auftrag ausführen	vin.
txanwetseng	Heimat, persönlich wichtiger oder geliebter Ort	n.
penghrr	warnen	vin.
säpenghrr	Warnung	n.
tì'ul	Erhöung, Anstieg	n.
eyawrfya	richtiger Weg (etwas zu tun), korrekte Weise	n.
stiwi	Unfug, Unheil, Schaden, Unsinn	n.
stiwi si	unartig, ungezogen, frech sein; Unfug treiben, Unheil anrichten	vin.
stiwinga'	frech, schelmisch, spitzbübisch	adj.
stiwisiyu	Unheilstifter, Tunichtgut, Störenfried	n.
rawng	Eingang, Zugang, Öffnung (durch die man eintreten kann)	n.
syewe	Fett (Substanz im Fleisch)	n.
syewenga'	fettig	adj.
laro si	säubern, von Schmutz befreien	vin.
slukx	Horn (eines Tieres)	n.
tsin	Nagel, Klaue	n.
ue'	sich übergeben, (etwas) erbrechen	vtr., vin.
nantangtsyìp	Hund (Erdentier); wörtl. kleiner Vipernwolf	n.
hiup	spucken, (etwas) ausspucken	vin., vtr.
