"Frontside"	"Flipside"	"Category"
'ampi	aanraken	vtr.
'angtsìk	hamerhoofd	n.
'aw	één	num.
'awkx	rotswand	n.
'awpo	één persoon	pn.
'awsiteng	samen	adv.
'awve	eerste (rangtelwoord)	adj.
'e'al	slechtste	adj.
'eko	aanvallen	vtr.
'ekong	ritme	n.
'engeng	vlak	adj.
'eveng	kind	n.
'evi	kindje (affectionate form of)	n.
'ewan	jong	adj.
'eylan	vriend	n.
'ì'awn	blijven	vin.
'ìheyu	spiraal	n.
'Ìnglìsì	Engels (taal)	n.
'it	beetje, kleine hoeveelheid	n.
'itan	zoon	n.
'ite	dochter	n.
'ok	herinnering	n.
'ong	bloeien	v.
'u	ding (object, feit)	n.
'upe	welk (ding)	inter.
'upxare	boodschap, bericht	n.
a	oorzaak attribuut markering	part.
alaksi	klaar	adj.
lìm	ver weg zijn	svin.
apxa	groot	adj.
atan	licht	n.
atokirina'	zaad van de Grote Boom	n.
atxkxe	land	n.
au	trommel (gemaakt van huiden)	n.
aungia	voorteken, omen	n.
awaiei	harpij van het paradijs	n.
awnga	wij	pn.
ayfo	zij	pn.
aynga	jullie allen, jullie	pn.
ayoe	wij (exclusief)	pn.
ayoeng	wij (inclusief)	pn.
äie	visie (spiritueel)	n.
äo	onderX	adp.
ätxäle	verzoek	n.
ätxäle si	verzoeken	vin.
ean	blauw, groen	adj.
eltu	brein	n.
eltu si	luisteren	vin.
eltungawng	breinworm	n.
emza'u	halen (bv. een test)	vtr.
eo	voor (plaats)	adp.
eyawr	juist, correct	adj.
eyaye	verentooi	n.
eyk	leiden	vtr.
eyktan	leider	n.
fa	met behulp van, door middel van	adp.
fahew	geur	n.
fìfya	op deze manier, zoals dit	adv.
fìkem	dit, deze (actie)	pn.
fìpo	dit, deze (persoon of ding)	pn.
fìtxan	zo (veel)	adv.
fìtseng	hier, deze plaats	adv., n.
fìtsenge	hier, deze plaats	adv., n.
fì'u	dit (ding)	pn.
fkarut	pellen	v.
fkew	machtig	adj.
fko	een, men (ongespecificeerd onderwerp)	pn.
flä	slagen	vin.
fmawn	nieuws, iets om te melden	n.
fmetok	testen	vtr.
fmi	proberen	vtrm.
fngap	metaal	n.
fngapsutxwll	metallofiele plant	n.
fnu	wees stil, stil zijn	vin.
fo	zij	pn.
fpak	actie uitstellen, wachten	v.
fpe'	zenden, sturen	vtr.
fpeio	uitdaging (ceremonieel)	n.
fpi	in het belang van, voor het nut van	adp.
fpìl	denken	vtr.
fpom	vrede, geluk	n.
fpxafaw	medusa	n.
fpxäkìm	binnenkomen	vin.
fra'u	alles	pn.
frakrr	altijd	adv.
frapo	iedereen	pn.
frrfen	bezoeken	vtr.
frrtu	gast, bezoeker	n.
ftang	stoppen	vim.
fte	zodat	conj.
fteke	zodat niet	conj.
ftia	studeren	vtr.
ftxì	tong	n.
ftxozä	feestdag, blijde gebeurtenis	n.
ftu	vanuit (richting)	adp.
ftue	makkelijk, simpel	adj.
ftxavang	hartstochtelijk	adj.
ftxey	kiezen	vtr.
fu	of	conj.
futa	dat	pn., sbd.
fwa	dat (gesubordineerd zinsdeel markering)	pn., sbd.
fya'o	pad, wijze, manier	n.
fyape	hoe	inter.
fyawìntxu	leiden (met het geleidde in datief)	vin.
ha	dus, in dat geval	adv.
hahaw	slapen	vin.
hapxì	deel	n.
hasey	klaar, gedaan	adj.
hawnu	beschermen	vtr.
hì'i	klein (in grootte)	adj.
hiyìk	grappig, vreemd	adj.
hol	weinig	adj.
holpxay	hoeveelheid	n.
hrrap	gevaar	n.
hu	met	adp.
hufwe	wind	n.
hum	weggaan	vin.
i'en	snaarinstrument	n.
ikran	harpij	n.
ikranay	bosharpij	n.
ioang	dier, beest	n.
irayo	bedankt, dank je	n., intj.
ìlä	via, volgens	adp.
ka	overheen, volledig bedekkend	adp.
kä	gaan	vin.
kali'weya	giftige spinnensoort	n.
kalin	zoet (smaak)	adj.
kaltxì	hallo	intj.
kämakto	uitrijden	v.
kame	(in)zien	vtr.
kan	doelen op, bedoelen; richten, een wapen of object op een doel richten	vtrm., vtr.
kangay	geldig	adj.
kar	leren, doceren	vtr.
karyu	leraar	n.
kato	ritme	n.
kawkrr	nooit	adv.
kawng	slecht	adj.
kawtu	niemand	pn.
ke	niet	adv.
ke'u	helemaal niets, helemaal niet	pn.
kehe	nee	part., intj.
kelku	thuis, huis	n.
kelku si	wonen	vin.
kem	actie, daad	n.
kempe	wat, welke (actie)	inter.
kenong	representeren	vin.
kerusey	dood	adj.
ketuwong	vreemdeling	n.
kewong	vreemd (buitenaards)	adj.
keye'ung	krankzinnigheid	n.
kifkey	wereld (fysiek, solide)	n.
kilvan	rivier	n.
kìm	(iets) draaien, laten tollen	vtr.
kin	nodig hebben	vtr.
kinam	been	n.
kinamtil	knie	n.
kìng	draad	n.
kip	tussen	adp.
kìte'e	dienst	n.
kllfro'	verantwoordelijk zijn	svin.
kllkulat	opgraven	vtr.
kllkxem	staan	vin.
kllpxìltu	gebied, territorium	n.
kllte	grond	n.
ko	instemmend	part.
kop	ook, alsmede, tegelijk met	adv.
koren	regel, richtlijn	n.
krr	tijd	n.
krrnekx	tijd verbruiken	vin.
krrpe	wanneer	inter.
kunsìp	gevechtsvliegtuig	n.
kurakx	uitdrijven	vtr.
kxam	midden	n.
kxamtseng	middelpunt, plaats in het midden	n.
kxangangang	boem (onomatopee)	intj.
kxanì	verboden	adj.
kxawm	misschien	adv.
kxener	rook	n.
kxetse	staart	n.
kxeyey	fout	n.
kxll	aanval	n.
lahe	ander	adj.
lam	lijken	vin.
lapo	(de) ander (persoon of ding)	pn.
latem	veranderen	vin.
law	zeker, duidelijk	adj.
lefpom	blij, vredig, plezierig, aangenaam	adj.
lertu	collega	n.
letrr	dagelijks	adj.
letsunslu	mogelijk	adj.
lì'u	woord	n.
lì'fya	taal	n.
lok	naderen, benaderen	vtr.
lonu	loslaten	vtr.
lor	mooi, aangenaam voor de zintuigen	adj.
loreyu	helicoradium spiraal, mooie spiraal	n.
lrrtok	glimlach	n.
lrrtok si	lachen	vin.
lu	zijn (existentieel)	vin., svin.
lun	reden	n.
lumpe	waarom	inter.
ma	aansprekende wijs	part.
makto	rijden	vtr.
mawey	kalm	adj.
mefo	zij, die twee	pn.
menari	ogen (twee)	n.
meoauniaea	harmonie, een zijn met de natuur	n.
meuia	eer	n.
meyp	zwak	adj.
mi	toch, nog, als voorheen	adv.
mip	nieuw	adj.
mikyun	oor	n.
mì	in, op	adp.
mìn	draaien, roteren om een as	vin.
mìso	weg (positie)	adv.
mllte	instemmen	vin.
moe	wij, wij twee (exclusief)	pn.
mokri	stem	n.
muiä	eerlijk, goed, terecht	adj.
mun'i	snijden	v.
mune	twee	num.
munge	brengen	vtr.
mungwrr	behalve	adp.
muntxa	getrouwd, een paar	adj.
na	(zo)als	adp.
na'rìng	bos, woud	n.
Na'vi	het Volk, inheemse bewoners van Pandora	prop.n.
nang	verrassing, uitroep, aanmoediging (voor onverwachte momenten of nieuwe informatie  miratief)	part.
nantang	slangewolf Caniferratus costatus, gestreepte gepantserde wolf	n.
nari	oog	n.
nari si	kijk uit, pas op!	vin.
nawm	groots, nobel	adj.
ne	naar, in de richting van	adp.
ne'ìm	terug (richting)	adv.
nekx	consumeren, verbranden	vtr.
neto	weg (richting)	adv.
new	willen	vtrm.
niä	grijpen	vtr.
nì'aw	alleen, slechts	adv.
nìawnomum	zoals je weet, zoals bekend (spreektaal [naw.no.mum])	adv.
nì'awtu	alleen	adv.
nì'awve	eerst	adv.
nì'it	een beetje, kleine hoeveelheid (abstract)	adv.
nì'ul	meer	adv.
nìayoeng	zoals wij (spreektaal  [naj.wEN])	adv.
nìftue	gemakkelijk	adv.
nìftxavang	gepassioneerd, met heel het hart	adv.
nìhawng	ook, overdreven	adv.
nìltsan	goed	adv.
nìmun	opnieuw	adv.
nìn	kijken, kijken naar	vtr.
nìngay	echt, waarlijk	adv.
nìtam	genoeg	adv.
nìteng	ook	adv.
nìtut	continu, doorlopend	adv.
nìtxan	veel (abstract), erg	adv.
nìwin	snel	adv.
nìwotx	alles (van), compleet	adv.
nulkrr	langer (tijd)	adv.
nulnew	verkiezen, de voorkeur geven aan (ii)	vtrm.
nume	leren	vin.
nga	jij	pn.
ngawng	worm	n.
ngay	waar	adj.
ngenga	jij (ceremonieel)	pn.
ngim	lang (fysieke lengte)	adj.
ngop	creëeren, maken	vtr.
ngrr	wortel	n.
nguway	gehuil, roep van een slangewolf	n.
oe	ik	pn.
oeng	wij twee (tweevoudig inclusief)	pn.
oeyk	oorzaak	n.
ohe	ik (ceremonieel)	pn.
olo'	stam, clan	n.
olo'eyktan	opperhoofd	n.
omum	weten	vtr.
ontu	neus	n.
pähem	arriveren, aankomen	vin.
pak	neerbuigend	part.
pa'li	grimpaard	n.
palulukan	thanator	n.
pam	geluid	n.
pamtseo	muziek	n.
pamtseowll	kattenoor, muziekplant	n.
pängkxo	praten, een gesprek voeren	vin.
pänutìng	beloven	vtr.
pätsì	insigne	n.
pawm	vragen	v.
pay	water, vloeistof	n.
paywll	waterplant, dapophet	n.
pe	vvn. markering	affix
pe'un	beslissen	vtr.
pefya	hoe	inter.
pehem	wat, welke (actie)	inter.
pehrr	wanneer	inter.
pelun	waarom	inter.
peng	vertellen	vtr.
penghrrap	dubbele zonneschijn	n.
peseng	waar	inter.
pesu	wie	inter.
peu	wat, welk (ding)	inter.
pey	wachten	vin.
pizayu	voorouder	n.
plltxe	spreken	v.
po	hij, zij	pn.
poan	hij (geen meervoudsvorm: gebruik (ay)fo)	pn.
poe	zij (geen meervoudsvorm: gebruik (ay)fo)	pn.
pongu	een groep mensen	n.
prrnen	kind, baby	n.
prrnesyul	knop, kiem	n.
prrte'	plezierig (van een activiteit)	adj.
pxan	waardig	adj.
pxasìk	weg ermee! (vulgair)	intj.
pxasul	vers, lekker (eten)	adj.
pxay	veel, velen	adj.
pxey	drie	num.
pxi	scherp (punt)	adj.
pxìm	vaak	adv.
pxiut	scheermespalm, sherpe boom	n.
pxorna'	episoth, plofzaad	n.
pxun	arm	n.
pxuntil	elleboog	n.
rä'ä	doe niet (negatief imperatief, voor commando's)	part.
ral	betekenis	n.
ralpeng	verklaren, interpreteren	vtr.
rawke	alarmroep (alarm)	intj.
rel	beeld	n.
reltseo	beeldende kunst	n.
reltseotu	kunstenaar (visueel)	n.
renu	patroon	n.
rey	leven	vin.
rikx	verplaatsen	vin.
rim	geel	adj.
rina'	zaad	n.
riti	steekvleermuis	n.
rol	zingen	v.
ronsem	verstand, bewustzijn	n.
rum	bal	n.
rumut	balboom	n.
run	vinden, uitvinden	vtr.
rutxe	alstublieft (beleefd vragen)	intj.
sa'nok	moeder	n.
sa'nu	mama (affectionate form of)	n.
san	gezegde, citaat	adv.
sänume	les, instructie	n.
säspxin	ziekte	n.
sempu	papa (affectionate form of)	n.
sempul	vader	n.
set	nu	adv.
sevin	mooi	adj.
seyri	lip	n.
seze	blauwe bloem	n.
si	(postpositioneel ongebonden hulpwerkwoord) doen, maken 	
sì	en (connects two things, can be attached as --sÃ¬: for clauses use)	conj.
sìk	einde citaat	adv.
sìlpey	hopen	vin.
sìlronsem	slim, verstandig (ding)	adj.
sìltsan	goed (in z'n soort), goed gedaan	adj.
ska'a	vernietigen	vtr.
skxawng	idioot	n.
slä	maar	conj.
slu	worden (zn. predicaat met ne in dubbelzinnige constructies)	vin.
sngä'i	beginnen, starten	vim.
sngä'ikrr	begin, starttijd (tijd)	n.
sngel	afval, vuilnis, troep	n.
sngeltseng	vuilnisbelt, afvalhoop	n.
snumìna	suf, niet slim	adj.
som	heet	adj.
somtìlor	lollieplant, hete schoonheid	n.
spaw	geloven	vtr.
spxam	paddenstoel, schimmel	n.
spe'e	vangen	vtr.
spe'etu	gevangene	n.
spxin	ziek	adj.
srak	indicatie voor ja/nee vraag	part.
srake	indicatie voor ja/nee vraag	part.
srane	ja	part., intj.
srew	dansen	vin.
srung	hulp, assistentie	n.
stawm	horen	vtr.
steftxaw	onderzoeken	vtr.
stum	bijna	adv.
sutx	opsporen, volgen	vtr.
swaw	moment	n.
swey	beste	adj.
swirä	wezen, creatuur	n.
swizaw	pijl	n.
swok	heilig	adj.
swotu	heilige plaats	n.
syaw	roepen	vin.
syulang	bloem	n.
ta	van (locatief), van (tijdsbepaling i.c.m. andere tijdwoorden)	adp.
ta'em	van boven	adv.
tafral	daarom, om die reden	adv.
täftxu	weven	vtr.
täftxuyu	wever	n.
takuk	raken, slaan, treffen	vtr.
talioang	stormbeest	n.
talun	omdat	conj.
taluna	omdat	conj.
tam	voldoen, dat is voldoende, oké	vin., intj.
tam tam	kalm kalm, rustig maar	intj.
tangek	boomstam	n.
tanhì	ster, lichtgevende sproet	n.
taron	jagen	vtr.
taronyu	jager	n.
tautral	hemelsboom	n.
taw	lucht, hemel	n.
taweyk	omdat, vanwege de reden	conj.
taweyka	omdat, vanwege de reden	conj.
tawsìp	luchtschip	n.
tawng	duiken, bukken	vin.
tawtsngal	panopyra, hemelbeker	n.
Tawtute	Luchtpersoon, mens	prop.n.
te	wordt gebruikt in volledige namen	part.
tel	ontvangen	vtr.
telem	koord	n.
teng	zoals, gelijk aan	adj.
tengfya	hetzelfde als (gelijke situatie)	conj.
tengkrr	terwijl, gelijk aan	conj.
teri	over, betreffende	adp.
terkup	doodgaan	vin.
teswotìng	gunnen	vtr.
teya	vol	adj.
teylu	keverlarven	n.
tewti	wow, uitroep van verrassing en plezier	intj.
til	gewricht, scharnier	n.
tirea	geest, ziel	n.
tireafya'o	zielenpad	n.
tireaioang	geestdier, totem	n.
tireapängkxo	in nauw contact staan (b.v. met natuur)	v.
tì'eyng	antwoorden	n.
tìfmetok	proef, test	n.
tìftang	stoppen, de glottale stop	n.
tìfyawìntxu	begeleiding	n.
tìhawnu	bescherming	n.
tìkangkem	werk	n.
tìkawng	(het) kwaad	n.
tìkenong	voorbeeld	n.
tìkin	noodzaak	n.
tìlor	schoonheid	n.
tìng	geven	vtr.
tìng mikyun	luisteren	vin.
tìng nari	kijken	vin.
tìngay	waarheid	n.
tìpawm	vraag	n.
tìran	lopen	vin.
tìyawn	liefde	n.
tìrey	leven	n.
tìrol	lied (vocaal)	n.
tìspxin	ziek zijn, een ziekte hebben	n.
tìtxur	kracht, sterkte	n.
to	vergelijkende markering dan (gedraagt zich als adp.)	part.
tok	zijn (plaats)	vtr.
toktor	dokter	n.
tokx	lichaam	n.
tompa	regen	n.
toruk	reuzenleonopteryx, Laatste Schaduw	n.
toruk makto	toruk berijder	n.
torukspxam	reuzenzwam, reuzenleonopteryxpaddestoel	n.
trr	dag	n.
trram	gisteren	adv.
tukru	speer	n.
tul	rennen	vin.
tung	toestaan	vtr.
tupe	wie	inter.
tut	geeft aan dat iets doorgaat	part.
tute	persoon	n.
tuté	vrouw (persoon)	n.
tutan	man (persoon)	n.
tsa'u	dat (ding)	dem.
tsaheylu	band (neurale verbinding)	n.
tsakem	dat, die (actie)	dem.
tsakrr	toen, op die tijd	adv.
tsam	oorlog	n.
tsampongu	oorlogsgroep	n.
tsamsiyu	krijger	n.
tsap'alute	verontschuldiging, excuus	n.
tsatseng	daar, die plaats	dem., n.
tsatu	die persoon	dem.
tsawke	zon	n.
tsawl	groot, lang	adj.
tsawlapxangrr	unideltaboom, let. hoge grote wortel	n.
tse'a	zien (fysiek)	vtr.
tseng	plaats	n.
tsenge	plaats	n.
tsengpe	waar	inter.
tseo	kunst	n.
tskalep	kruisboog	n.
tsko	boog (wapen)	n.
tsko swizaw	pijl en boog	n.
tskxe	rots, steen	n.
tskxekeng	training, oefening	n.
tslam	begrijpen	vtr.
tsleng	vals, onwaar	adj.
tslolam	begrepen, ik snap het	intj.
tsmuk	broer/zus (unisex aanduiding)	n.
tsmuktu	broer/zus (unisex aanduiding)	n.
tsmukan	broer	n.
tsmuke	zus	n.
tsnì	dat (functiewoord)	sbd.
tsngal	beker	n.
tspang	doden	vtr.
tsranten	van belang zijn	vin.
tstew	dapper	adj.
tstxo	naam	n.
tsun	kunnen	vim.
tswayon	vliegen	vin.
tsyal	vleugel	n.
tsyo	meel	n.
tsyorina'wll	cycade, meelzadenplant	n.
txan	veel	adj.
txantsan	geweldig, uitstekend	adj.
txantslusam	wijs	adj.
txe'lan	hart	n.
txele	zaak	n.
txen	wakker	adj.
txep	vuur	n.
txewk	knuppel (wapen)	n.
txey	stoppen	v.
txìm	kont, achterste	n.
txìng	achterlaten	vtr.
txll'u	hooka kalebas	n.
txo	als, wanneer	conj.
txoa	vergiffenis	n.
txokefyaw	als niet, anders	conj.
txon	nacht	n.
txopu	angst	n.
txula	bouwen	vtr.
txum	vergif	n.
txumpaywll	schorpioendistel, giftige water plant	n.
txumtsä'wll	Baja kietelaar, vergifspuwende plant	n.
txur	sterk (fysiek)	adj.
ulte	en (verbindt zinsdelen)	conj.
ultxa	ontmoeting, vergadering	n.
unil	droom	n.
uniltìrantokx	Avatar, droomwandellichaam	n.
uniltìranyu	droomwandelaar, Avatarbestuurder	n.
utral	boom	n.
uvan	spel	n.
uvan si	spelen	vin.
vay	omhoog naar	adp.
virä	verspreiden	v.
vrrtep	demoon	n.
vul	tak (van een boom)	n.
way	lied (oud, ceremonieel)	n.
waytelem	akkoord (muziek)	n.
win	snel	adj.
wìntxu	laten zien	vtr.
'ewll	plant	n.
wrrpa	buiten	n., adv.
wutso	maaltijd	n.
ya	lucht	n.
yawne	geliefd	adj.
ye'rìn	binnenkort	adv.
yerik	hexapoot	n.
yey	recht	adj.
yìm	binden	vtr.
yol	lang (tijd)	adj.
yom	eten	vtr.
yomhì'ang	klein dier/insecteneter, dakteron	n.
yomioang	kelkplant, vleesetende plant	n.
yomtìng	voeren	vin.
yur	wassen	vtr.
za'ärìp	trekken	vtr.
za'u	komen	vin.
zamunge	brengen	vtr.
zawng	gil, schreeuw	vin.
zekwä	vinger	n.
zene	moeten	vim.
zìsìt	jaar	n.
zong	redden, verdedigen	vtr.
zongtseng	veilige plek, schuilplaats	n.
zoplo	belediging	n.
zusawkrr	toekomst	n.
Jakesully	idioot, zesde Toruk Makto	n.
'ärìp	(iets) verplaatsen	vtr.
'awstengyem	twee dingen samenvoegen (ii)	vtr.
'efu	voelen	vtr.
'em	koken	vtr.
'eyng	antwoorden	v.
'i'a	beëindigen	vin.
'ia	opgaan in (spiritueel)	vin.
fkxake	jeuken	v.
fmal	volhouden	vtr.
frìp	bijten	vtr.
ftem	(iets) passeren	vtr.
fwew	zoeken	vtr.
hangham	lachen	vin.
vaykrr	totdat	conj.
sngap	steken	vtr.
hawl	voorbereiden	vtr.
kä'ärìp	duwen	vtr.
kavuk si	verraden	vin.
kllkä	afdalen, omlaag gaan	vin.
latsi	(iemand) bijhouden	v.
lek	gehoorzamen, luisteren naar	vtr.
len	gebeuren	vin.
lew si	bedekken	vin.
muntxa si	paren (met iemand)	vin.
näk	drinken	vtr.
nong	volgen	vtr.
oeyktìng	uitleggen (ii)	vtr.
pate	aankomen (op een plaats), arriveren	v.
piak si	openen	vin.
pom	kussen, zoenen	vtr.
pxor	ontploffen	vin.
salew	doorgaan	v.
sar	gebruiken	vtr.
sim	dichtbij zijn	svin.
sleyku	produceren, maken	vtr.
sop	reizen	vin.
spä	springen	v.
speng	terughalen	vtr.
spule	voortstuwen	vtr.
srese'a	voorspellen	vtr.
steyki	(iemand) kwaad maken	vtr.
sti	ergeren (onovergangelijk), kwaad zijn	vin.
sto	weigeren (iets te doen)	vtrm.
sung	toevoegen	vtr.
syep	vangen (in een val leiden)	vtr.
tatep	de draad kwijtraken	vtr.
tätxaw	terugkeren	vin.
tem	schieten	vin.
tì'awm si	kamperen	vin.
tì'awm	kamp	n.
tìkangkem si	werken	vin.
tìng tseng	terugtrekken	vin.
tìsraw seyki	pijn doen (iets of iemand)	vtr.
tìsraw	pijn	n.
tìsraw si	pijn hebben, pijnlijk zijn	vin.
toltem	schieten	vtr.
tsä'	spuiten	v.
tsaheyl si	verbinden met, een neurale verbinding maken met	vin.
tsap'alute si	verontschuldigen	vin.
tsawl slu	groeien	vin.
tsngawvìk	huilen	vin.
tsre'i	gooien	vtr.
tstu si	sluiten	vin.
tsunslu	mogelijk zijn	vin.
tsurokx	rusten	vin.
tungzup	laten vallen	vtr.
wem	vechten	vin.
win säpi	opschieten	vin.
win si	iets haasten, iets snel laten gaan	vin.
yän	vastmaken, vastbinden	vtr.
yem	neerzetten, plaatsen	vtr.
zenke	niet moeten (ii)	vim.
zup	vallen	vin.
nekll	omlaag (richting)	adv.
srung si	helpen	vin.
txopu si	bang zijn	vin.
fkip	boven tussen	adp.
io	boven, over	adp.
kxamlä	door (via het midden van)	adp.
lok	dicht bij	adp.
maw	na (tijd)	adp.
mìkam	tussen	adp.
nemfa	erin, naar binnen	adp.
pxaw	rondom	adp.
pxel	(zo)als	adp.
sìn	op	adp.
takip	van tussen	adp.
uo	achter	adp.
luke	zonder	adp.
tafkip	van boven	adp.
ro	op (locatief)	adp.
sre	voor (tijd)	adp.
wä	tegen (als in: vechten tegen)	adp.
fäpa	top, bovenkant	n.
alìm	ver weg, op een afstand	adv.
aylaru	naar de anderen	pn.
kxu	onheil, schade	n.
eltu lefngap	computer	n.
kì'ong	langzaam	adj.
säfpìl	idee	n.
kefyak	is het niet?, toch?	part.
prrwll	mos	n.
pängkxoyu lekoren	advocaat	n.
pamrel	geschrift	n.
pamrel si	schrijven	vin.
furia	dat	pn., sbd.
fratseng	overal	adv.
fratrr	dagelijks, elke dag	adv.
frato	overtreffende trap dan alles	part.
trray	morgen	adv.
kea	geen (voor zn.)	adj.
ngian	echter	adv.
skepek	formeel	adj.
hufwa	alhoewel	conj.
tup	in plaats van, liever dan	conj.
'uo	iets	pn.
tuteo	iemand	pn.
tsengo	ergens	pn.
holpxaype	hoeveel	inter.
hìm	klein (hoeveelheid)	adj.
hìmtxampe	hoeveel	inter.
hìmtxan	aantal	n.
pìmtxan	hoeveel	inter.
lì'upe	wat, welk (woord, uiting)	inter.
pelì'u	wat, welk (woord, uiting)	inter.
ultxarun	ontmoeten	vtr.
ultxa si	iemand doelbewust ontmoeten (gebruikhu met)	vin.
rangal	wensen	vin.
nìrangal	wens (t.o.v. feit, met (im)perfectief subjunctief)	adv.
txepvi	vonk	n.
nitram	blij (voor mensen)	adj.
fewi	(op)jagen	vtr.
stä'nì	vangen	vtr.
sran	ja (omgangstaal)	part., intj.
weyn	tekenen, illustreren	vtr.
fìtrr	vandaag	adv.
rusey	levend, in leven, iets levends	adj., n.
vitra	ziel	n.
nìzawnong	veilig	adv.
ftawnemkrr	verleden	n.
txal	rug (van het lichaam)	n.
tsìng	vier	num.
mrr	vijf	num.
pukap	zes	num.
kinä	zeven	num.
vol	acht	num.
zam	vierenzestig	num.
tìoeyktìng	uitleg	n.
lesar	nuttig	adj.
tse	nou (conversatie starter)	part.
skxom	kans, mogelijkheid	n.
fkxen	groente (eten)	n.
syä'ä	bitter	adj.
yemfpay si	onderdompelen	vin.
yemfpay	onderdompelen (in vloeistof)	n.
keng	gelijk aan, zoveel als	adv.
'awlo	eens	adv.
melo	tweemaal	adv.
heyn	zitten	vin.
nìpxim	rechtop	adv.
pxim	rechtop	adj.
tuvon	leunen	v.
nìfya'o	op een manier	adv.
letrrtrr	gewoon	adj.
nì'eoio	ceremonieel	adv.
'eoio	ceremonieel	adj.
rìk	blad	n.
lerìk	bladrijk	adj.
pa'o	kant	n.
kllpa	bodem	n.
mìfa	binnen	n., adv.
nefä	omhoog (richting)	adv.
zapxì	voorkant (deel of sectie)	n.
käpxì	achterkant (deel of sectie)	n.
käsatseng	daar buiten	adv.
ftxey	weder, of	conj.
ngaytxoa	sorry, mijn excuses (uiting van schuld en spijt)	intj.
flew	keel	n.
kxa	mond	n.
nikre	haar	n.
pewn	nek	n.
re'o	hoofd	n.
sre'	tand	n.
tsuksìm	kin	n.
key	gezicht	n.
puk	boek	n.
ngäng	maag	n.
ta'leng	huid	n.
tsyokx	hand	n.
reypay	bloed	n.
tsopì	long	n.
venu	voet	n.
venzek	teen	n.
ramunong	bron	n.
payfya	stroom	n.
pxawpa	grens, afbakening, omtrek	n.
txampay	zee, oceaan	n.
'ora	meer	n.
ekxan	barricade, obstakel	n.
tsim	bron, oorsprong	n.
tsray	dorp	n.
txayo	veld, open terrein	n.
ukxo	droog	adj.
wew	koud	adj.
fìtxon	vannacht	adv., n.
txonam	vorige nacht	adv.
txonay	morgennacht	adv.
sekrr	heden	n.
vur	verhaal	n.
tìpängkxo	conversatie, discussie	n.
tìsrese'a	profetie	n.
nawmtu	groot persoon	n.
txantstew	held	n.
syuve	voedsel (collectief zn., kan niet in meervoud worden gebruikt)	n.
tsngan	vlees	n.
tstal	mes	n.
tete	bot (als bij mes)	adj.
lew	deksel	n.
'opin	kleur	n.
leNa'vi	te doen hebben met de Na'vi, het Volk	adj.
nìNa'vi	als de Na'vi	adv.
hapxìtu	lid	n.
'Rrta	Aarde	prop.n.
fwäkìwll	sprinkhaan orchidee	n.
hì'ang	insect	n.
payoang	vis	n.
yayo	vogel	n.
zize'	hellevuurwesp	n.
kemlì'u	werkwoord	n.
tstxolì'u	zelfstandig naamwoord	n.
ftär	links (niet rechts)	adj.
skien	rechts (niet links)	adj.
'änsyem	compleet	adj.
wotx	totaliteit, geheel	n.
mowan	plezierig, aangenaam (fysiek, sexueel)	adj.
vä'	onplezierig voor de zintuigen, luid	adj.
tatlam	blijkbaar	adv.
keteng	verschillend	adj.
numtseng	school	n.
skxakep	waarschijnlijk	adj., adv.
tìprrte'	plezier	n.
kaw'it	helemaal niet, geen beetje (gebruikt met ke; zie ke kaw'it helemaal niet in uitdrukkingen)	adv.
nìlkeftang	voortdurend, zonder stoppen	adv.
tì'i'avay	tot het eind	adv.
'awm	kamp	n.
tìska'a	vernietiging	n.
tìsop	reis	n.
wempongu	squadron, militaire clan, oorlogsgroep	n.
asim	nabij	adv.
klltseng	positie	n.
kxutu	vijand	n.
mekre	voorraad	n.
tìhawl	voorbereidingen, plan	n.
tìkan	doel, goal	n.
tìpähem	aankomst	n.
numeyu	student, leerling	n.
soaia	familie (onregelmatige genitieve vorm soaiä)	n.
tìmuntxa	paren, huwelijk	n.
yawnetu	geliefde	n.
yawntu	geliefde	n.
kakrel	blind	adj.
kanu	slim, intelligent (van een persoon)	adj.
koak	oud, hoge leeftijd (voor levende dingen)	adj.
lekye'ung	gek, waanzinnig	adj.
me'em	harmonieus	adj.
txanew	hebberig	adj.
txantur	krachtig	adj.
tì'awpo	individualiteit (negatieve lading), egoïsme	n.
tì'eylan	vriendschap	n.
fkay	hatelijk	adj.
keltsun	onmogelijk	adj.
kxuke	veilig	adj.
lehawng	overdadig	adj.
hawng	overvloed	n.
lekin	nodig	adj.
stxong	vreemd, onbekend	adj.
syen	laatst	adj.
kavuk	verraad	n.
fpìlfya	gedachtenpatroon, manier van denken	n.
syay	lot (noodlot)	n.
tìfnu	stilte	n.
tìngop	creatie (abstract idee)	n.
tìpe'un	beslissing	n.
kxitx	dood	n.
trr'awve	zondag	n.
trrmuve	maandag	n.
trrpxeyve	dinsdag	n.
trrtsìve	woensdag	n.
trrmrrve	donderdag	n.
trrpuve	vrijdag	n.
trrkive	zaterdag	n.
'ango	zacht (geluid)	adj.
kxayl	hoog	adj.
rey'eng	de Balans van het Leven	n.
tìme'em	harmonie (algemeen gevoel)	n.
fnel	soort, type	n.
fnepe	welk soort	inter.
pefnel	welk soort	inter.
zerok	herinneren	vtr.
tswa'	vergeten	vtr.
tì'efu	gevoel	n.
maweypey	geduld hebben (ii)	svin.
tìmweypey	geduld	n.
lemweypey	geduld	adj.
nìmweypey	geduldig	adv.
tsakrrvay	tot dan, ondertussen	adv.
ohakx	hongerig	adj.
tìohakx	honger	n.
tsyosyu	eten gemaakt van meel	n.
vey	dierlijk voedsel, vlees	n.
trrpeve	welke dag (komt van trr dag en pe vvn. markering en ve telwoord markering)	inter.
pxiswawam	een moment geleden, nu net	adv.
pxiset	nu meteen, onmiddellijk	adv.
pxiswaway	zo meteen, over een seconde	adv.
pxiye'rìn	direct (niet zo snel als pxiswaway)	adv.
pxisre	vlak voor	adp.
pximaw	meteen na	adp.
sok	recent	adj.
'awlie	eens (in het verleden)	adv.
tìkxey	incorrectheid, fout	n.
tìkxey si	verkeerd doen, blunderen	vin.
tìyawr	correctheid	n.
tìketeng	verschil	n.
fpomtokx	gezondheid (fysiek)	n.
lefpomtokx	gezond (fysiek)	adj.
kelfpomtokx	ongezond (fysiek)	adj.
keftxo	ongelukkig, van streek, 'Wat erg!'	adj., intj.
nìkeftxo	helaas, jammer genoeg	adv.
sraw	pijnlijk	adj.
txampxì	meerderheid, grootste deel	n.
vurvi	samenvatting	n.
sänumvi	les	n.
letam	genoeg	adj.
letsranten	belangrijk	adj.
nìswey	optimaal, best	adv.
nìpxi	specifiek, precies	adv.
wok	luid	adj.
spuwin	oud, van voorheen	adj.
nì'eyng	terug, in antwoord op	adv.
nìkanu	intelligent, op een slimme manier	adv.
nìlaw	duidelijk	adv.
tìsti	woede	n.
tìtxanew	hebzucht	n.
tìftxey	keuze	n.
tìkanu	inteligentie	n.
tìlam	voorkomen	n.
tìtslam	begrip, intelligentie	n.
tìtxula	constructie, gebouwd ding	n.
hewne	zacht (ding)	adj.
tìm	laag	adj.
laro	schoon	adj.
tsewtx	smerig	adj.
lefngap	metalig, van metaal	adj.
txa'	hard	adj.
fwel	kapot	adj.
etrìp	gunstig, voorspoedig	adj.
piak	open, helder (voor wolkenloze hemel)	adj.
tstu	gesloten, dicht  (voor bewolkte hemel)	adj.
kxll si	(op)laden	vin.
tsaw	dat, het (als nietovergankelijk onderwerp)	dem., pn.
tsalsungay	ondanks dat	adv.
oìsss	boze kreet, 'kijk maar uit!'	intj.
saa	bedreigende kreet	intj.
sau	uitroep van uitputting	intj.
tsahey	uitroep van waarschuwing of frustratie, 'oh, nee!'	intj.
wiya	uitroep van waarschuwing of frustratie, 'verdomme!'	intj.
ìley	oorlogskreet	intj.
vawm	donker	adj.
tìvawm	duisternis	n.
polpxay	hoeveel	inter.
ke'aw	verdeeld, uit elkaar gehaald	adj.
nìsti	boos	adv.
teyr	wit	adj.
layon	zwart	adj.
pänu	belofte	n.
kew	nul	num.
'eyt	het symbool 8 (niet de waarde acht)	n.
nayn	het symbool 9 (niet de waarde negen)	n.
trr'ong	vroege ochtend, zonsopgang	n.
trr'ongmaw	dag na zonsopgang	n.
rewon	ochtend	n.
srekamtrr	de tijd voor middag (12 uur 's middags)	n.
kxamtrr	middag (12 uur 's middags)	n.
kxamtrrmaw	de tijd net na middag, vroege namiddag	n.
ha'ngir	middag	n.
kaym	avond (voor schemering, late middag)	n.
sreton'ong	avond voor zonsondergang	n.
txon'ong	zonsondergang	n.
txon'ongmaw	schermering, voor donker, na zonsondergang	n.
srekamtxon	voor middernacht	n.
kxamtxon	middernacht	n.
kxamtxomaw	na middernacht	n.
sresrr'ong	voor zonsopgang	n.
wou	verbazing wekken (spreektaal)	svin.
tsyìräfì	giraf	n.
tsawa	dat	pn., sbd.
tsata	dat	pn., sbd.
tsaria	dat 	pn., sbd.
alo	tijd, beurt, een van een herhalende actie	n.
fralo	elke keer, elke tijd	adv.
nìmwey	kalm, vredig	adv.
ku'up	zwaar (fysiek gewicht)	adj.
syo	licht (fysiek gewicht, lichtgewicht)	adj.
hay	volgend(e)	adj.
ham	vorig(e)	adj.
matsa	matse, broodkoek	n.
hametsì	ongedesemd brood	n.
tìkangkemvi	project, werkstuk	n.
nì'i'a	eindelijk	adv.
nìsyen	als laatste	adv.
pìlok	blog	n.
tsulfätu	expert, meester van een vak, kunst of vaardigheid	n.
tsulfä	meesterschap	n.
tsulfä si	zich meester maken	vin.
numtsengvi	klaslokaal, deel v.e. school	n.
rofa	naast, langs	adp.
pum	vervangwoord (plaatsvervangend voornaamwoord, verwijst naar eerder genoemd zn. of vn.)	pn.
Yuesey	Verenigde Staten	prop.n.
teya si	vullen (met datief van een gevuld ding)	vin.
alunta	vanwege, omdat	conj.
nìprrte'	aangenaam, met plezier	adv.
sngä'iyu	beginner	n.
srekrr	voordat, alreeds, voor de tijd	adv.
ayu	dingen	n.
tsafya	op die manier, zo	adv.
muve	tweede (rangtelwoord)	adj.
pxeyve	derde (rangtelwoord)	adj.
tsìve	vierde (rangtelwoord)	adj.
mrrve	vijfde (rangtelwoord)	adj.
puve	zesde (rangtelwoord)	adj.
kive	zevende (rangtelwoord)	adj.
volve	achtste (rangtelwoord)	adj.
tsyänel	tv kanaal	n.
trrtxon	de dag en nacht cyclus van Pandora	n.
au	uitroep van ontsteltenis	intj.
pängkxoyu	gepraat	n.
lekoren	gerechtelijk	adj.
prrkxentrrkrr	rookplezier overdag, trillende tong (Na'vi idioom)	n.
tìftia	studie	n.
tìftia kifkeyä	wetenschap, de studie van de fysieke wereld	n.
pxir	bier	n.
eanean	cheadle, kruidachtige plant	n.
'ele'wll	doornpoot, cactus	n.
tstxa'a	canalyd	n.
pa'liwll	grimpaard bekerplant	n.
anìheyu	fibonacci, blauwe spiraalplant	n.
tompawll	geode, regenplant	n.
pxiwll	heremiet knop plant	n.
syeptute	hyneman, mensen vanger	n.
kllpxiwll	leeuwenbes	n.
smaoe	falanxia, plant met veel doorns	n.
'ä'o	bekerplant	n.
mulpxar	hanenkop plant	n.
flefle	Sol's verrukking, magnetotropische plant	n.
kxaylte	cillafant	n.
fkxakewll	jeukplant	n.
tìhawnuwll	spartaan, beschermingsplant	n.
pxorna'lor	sari, mooi ontploffende zaadplant	n.
pxayzekwä	prikkende zwepen	n.
mìnyu	draaier, gedraaide lelie	n.
mìnyu	draaier	n.
väfewll	centipede, stinkende plant	n.
sngukx	engerling plant	n.
rawp	blaaspoliep	n.
'ampirikx	bladbekerplant	n.
apxangrr	deltaboom	n.
värumut	aderpeul	n.
keyawr	verkeerd, fout, niet goed	adj.
lehrrap	gevaarlijk	adj.
tìtxen	wakker zijn, de staat van wakkerheid	n.
hìrumwll	pufplant	n.
fwäkì	bidsprinkhaan	n.
fratxon	elke nacht	adv.
hìkrr	seconde, korte tijd	n.
mawkrr	na, achteraf	adv.
ngeyn	moe	adj.
ngopyu	maker	n.
nìk'ong	langzaamaan	adv.
pamtseotu	muzikant	n.
sat	dat	pn.
tsal	dat, het (overgankelijk onderwerp)	pn.
tsat	dat, het (als lijdend voorwerp)	pn.
tsawlhì'	grootte	n.
lì'fyavi	uitdrukking, stuk taal	n.
nafì'u	zulk (een)	adj.
lì'fyaolo'	taalgroep, taalgebruikers	n.
puktsyìp	pamflet, boekje	n.
utraltsyìp	struik	n.
säspxintsyìp	kleine aandoening	n.
'itetsyìp	dochtertje (kooswoord)	n.
sa'nutsyìp	moedertje (gebruikt voor jonge meisjes)	n.
kem si	doen	vin.
tswin	vlecht, staart	n.
tswintsyìp	vlechtje, staartje	n.
taronyutsyìp	jagertje	n.
oetsyìp	kleine ik	pn.
ngatsyìp	kleine jij	pn.
atanvi	lichtstraal	n.
txeptsyìp	lief klein vuurtje	n.
tìkusar	onderwijzen (het onderwijs)	n.
tìyusom	eten (het doen)	n.
tìtusaron	jagen	n.
tìpängkxotsyìp	kleine conversatie, praatje	n.
hayalo	volgende keer	adv.
hamalo	vorige keer	adv.
tstunwi	vriendelijk, attent	adj.
seykxel	sterk (emotioneel, spiritueel, niet fysiek), vol vertrouwen	adj.
fuke	of niet	conj.
'a'aw	enkele, verschillende	adj.
'okrol	geschiedenis (oud)	n.
'okvur	geschiedenis (niet oud)	n.
alu	datt s, met andere woorden	conj.
fnawe'	laf	adj.
fnawe'tu	lafaard	n.
ftxìlor	lekker, goed smakend	adj.
ftxìvä'	vies, slecht smakend	adj.
fyeyn	rijp, volwassen	adj.
fyeyntu	volwassen persoon	n.
tìfyeyn	rijpheid, volgroeidheid	n.
hawngkrr	laat	adv.
lehawngkrr	laat	adj.
leye'krr	vroeg	adj.
hek	benieuwd zijn, vreemd, onverwacht	vin.
nìhek	vreemd	adv.
ki	maar liever, in plaats van	conj.
nìfyeyntu	als een volwassene, volwassen	adv.
nì'eveng	als een kind, onvolwassen	adv.
lìng	zweven in de lucht	vin.
ram	berg	n.
muntxatu	ega, echtgenoot/echtgenote	n.
muntxatan	man, echtgenoot	n.
muntxate	vrouw, echtgenote	n.
netrìp	gelukkig, fortuinlijkerwijs	adv.
newomum	nieuwsgierig zijn, willen weten	svin.
lenomum	nieuwsgierig	adj.
tìnomum	nieuwsgierigheid	n.
ngäzìk	moeilijk, zwaar	adj.
tìngäzìk	moeilijkheid, probleem	n.
nìsung	daarnaast, tevens	adv.
reng	ondiep (fysiek)	adj.
rolun	Eureka!, ik heb het gevonden!	intj.
sa'sem	ouder of ouders	n.
smar	prooi, waarop gejaagd wordt	n.
starsìm	verzamelen, vergaren	vtr.
sunu	prettig of leuk zijn, plezier brengen	vin.
syayvi	geluk, fortuin	n.
nìsyayvi	per ongeluk, per toeval	adv.
tolel	Eureka, ik heb het gevonden!, ik begrijp het!	intj.
txukx	diep (fysiek)	adj.
ve'kì	haten	vtr.
tìve'kì	haat	n.
yaymak	dom	adj.
ye'krr	vroeg	adv.
zìsìkrr	seizoen	n.
zo	gezond zijn, goed functioneren, zijn zoals het hoort	svin.
zoslu	heel, word gezond (ii)	vin.
zeyko	helen, repareren	vtr.
frawzo	alles is goed	intj.
kemlì'uvi	infix	n.
irayo si	bedanken, dank geven	vin.
lefkrr	huidig	adj.
lì'upam	accent	n.
natkenong	bijvoorbeeld, als voorbeeld	conj.
eltur tìtxen si	interessant of intrigerend zijn	vin.
pxelo	drie keer	adv.
pamrelfya	spelling	n.
law si	duidelijk maken	vin.
tìsung	toevoeging, post script (p.s.)	n.
naer	drankje, iets dat gedronken kan worden	n.
atxkxerel	(land)kaart	n.
nìtengfya	ook, hetzelfde als (gelijke actie)	adv.
tun	rood, oranje	adj.
'om	violet, paars, magenta	adj.
neyn	lichte kleuren, wittinten	adj.
ngul	grijs, grauw	adj.
tumpin	rood, oranje	n.
eampin	blauw, groen	n.
rimpin	geel	n.
'ompin	violet, paars, magenta	n.
layompin	zwart	n.
teyrpin	wit	n.
vawmpin	donkere kleur	n.
neympin	lichte kleur	n.
ngulpin	grijs	n.
pil	gezichtsstreep	n.
ta'lengean	huidblauw	adj.
rìkean	bladgroen	adj.
kllvawm	bruin (gronddonker)	adj.
'evan	jongen (spreektaal)	n.
'eve	meisje (spreektaal)	n.
'evengan	jongen	n.
'evenge	meisje	n.
fkio	tetrapteron	n.
kenten	waaierhagedis	n.
nìwä	in tegendeel	adv.
pìwopx	wolk	n.
ramtsyìp	heuvel	n.
syaksyuk	prolemuris	n.
tor	laatste, uiteindelijke	adj.
txärem	bot (gebeente)	n.
uk	schaduw	n.
yapay	mist, stoom	n.
tìspe'e	vangen	n.
tìftxavang	passie	n.
tìtstunwi	vriendelijkheid	n.
stxeli	kado	n.
ngrrpongu	burgerinitiatief, activisme (van grassroot)	n.
smon	familiair zijn	vin.
lawk	praten over, iets zeggen/uitweiden over	vtr.
hìtxoa	sorry, vergeef me	intj.
mäkxu	onderbreken, uit harmonische balans gooien	vtr.
hultstxem	hinderen	vtr.
mok	voorstellen, suggereren	vtr.
muwìntxu	introduceren, voorstellen	vtr.
kan'ìn	focussen op, specialiseren in, geïnteresseerd zijn in	vtr.
tìwusem	vechten	n.
nì'eng	gelijk, op gelijk niveau	adv.
Pari	Parijs	prop.n.
tì'ong	bloeien	n.
tìmok	suggestie	n.
tì'em	kookkunst	n.
leyn	herhalen	vtr.
päsketpol	basketbal	n.
nìFranse	Frans, in het Frans	adv.
nìToitsye	Duits	adv.
nìno	in detail, uitgebreid	adv.
hìno	fijn, precies, gedetailleerd (van dingen)	adj.
leno	diepgaand, gedetailleerd (van een persoon)	adj.
tìno	diepgaandheid, precisie, gedetailleerdheid	n.
'ongokx	geboren worden	vin.
nokx	baren	vtr.
nìtrrtrr	dagelijks, regelmatig	adv.
tìn	activiteit die je bezig houdt	n.
txin	eerste, primaire	adj.
txintìn	bezigheid, primaire rol in de gemeenschap	n.
'emyu	kok	n.
vewng	letten op, verantwoordelijk zijn voor	vtr.
kaltxì si	groeten, hallo zeggen	vin.
sopyu	reiziger	n.
fula	dat	pn., sbd.
tskxekeng si	oefenen, trainen	vin.
way si	zingen	vin.
swawtsyìp	een kort moment, seconde	n.
käteng	samen zijn met	vin.
'ìn	bezig zijn, druk zijn	svin.
Sweriye	Zweden	prop.n.
nìfkrr	tegenwoordig, momenteel	adv.
sulìn	bezig zijn (positief), iets doen wat je leuk en opwekkend vindt	svin.
vrrìn	bezig zijn (negatief), moe/overweldigd zijn door een activiteit	svin.
tìk'ìn	vrije tijd	n.
säsulìn	hobby, plezierige activiteit	n.
'o'	wat plezier brengt, opwindend	adj.
Europa	Europa	prop.n.
skxaypxe	Skype	n.
pxorpam	ejectieve medeklinker	n.
tì'o'	plezier, opwinding	n.
nì'o'	op een plezierige manier	adv.
fnan	goed zijn in	vtr.
wätx	slecht zijn in	vtr.
tìsom	hitte	n.
tìwew	kou, koude	n.
tìlen	gebeurtenis	n.
nìnäk	door te drinken	adv.
nìhay	volgend(e)	adv.
sayrìp	knap, goed uitziend	adj.
letokx	lichamelijk, fysiek	adj.
säzärìp	lijn, teugels	n.
ìpxa	varen	n.
tìhawnu si	beschermen	vin.
sno	hemzelf, haarzelf, hetzelf (reflexief, genitieve vorm sneyä)	pn.
kìte'e si	bedienen	vin.
var	in iets volharden, iets constant blijven doen	vim.
nìftxan	zo, in zoverre	adv.
Yeysu	Jezus	prop.n.
lelì'fya	betrekking hebbend op taal	adj.
takrra	sinds (tijd)	conj.
akrrta	sinds (tijd)	conj.
few	tegenover, mikkend op de overkant van	adp.
fewtusok	tegenover, aan de overkant	adj.
sla'tsu	beschrijven	vtr.
tìsla'tsu	omschrijving	n.
'en	gok, voorgevoel, intuitie	n.
'en si	een gegronde gok doen	vin.
le'en	speculatief, intuïtief	adj.
nì'en	een gegronde gok doen, op intuïtie ageren	adv.
sä'o	gereedschap	n.
pamtseo si	muziek maken (met fa voor het bespeelde instrument)	vin.
väng	dorstig	adj.
tìväng	dorst	n.
sngum	zorg	n.
nìsngum	zorgelijk	adv.
yayayr	verwarring	n.
wäte	discussieren, redetwisten	vtr.
tìwäte	dispuut, redetwist	n.
säwäte	bron van dispuut, reden van het argument	n.
lewäte	onverkwikkelijk, onprettig	adj.
nìwäte	onverkwikkelijk, onprettig	adv.
li	al, reeds	adv.
lisre	tot, voor, tot aan maar niet na	adp.
ronsrelngop	verbeelden, zich voorstellen (c.w. van ronsem geest, rel afbeelding, ngop maken, spreektaal [Ron.sREw.Nop] )	vtr.
ronsrel	iets verbeeld	n.
tìronsrel	verbeelding	n.
txanatan	helder, levendig	adj.
leronsrel	denkbeeldig	adj.
nìronsrel	door verbeelding	adv.
srefey	verwachten	vtr., vin.
mawl	half	n.
pan	derde, een derde	n.
wan	verbergen	vtr.
nìwan	heimelijk, door te verbergen	adv.
tìwan	verdoezelen, bedekken	n.
letwan	achterbaks (van een persoon)	adj.
slele	zwemmen	vin.
nìslele	door te zwemmen, zwemmend	adv.
tìtaron	jagen	n.
ìì	uhm, eh (aarzeling)	intj.
tsukyom	eetbaar	adj.
ketsuktswa'	onvergetelijk	adj.
tsuktswa'	vergetelijk, vergeetbaar	adj.
yafkeyk	weer	n.
fkeytok	bestaan	vin.
tìfkeytok	situatie, conditie, staat	n.
tompameyp	motregen	n.
tskxaytsyìp	hagel	n.
tskxepay	ijs	n.
herwì	sneeuw	n.
tomperwì	natte sneeuw	n.
txanfwerwì	sneeuwstorm	n.
hermeyp	sneeuwbui	n.
hertxayo	sneeuwveld	n.
ìlva	vlok, druppel	n.
txepìva	as	n.
herwìva	sneeuwvlok	n.
payìva	waterdruppel	n.
tompìva	regendruppel	n.
kintrr	week	n.
mrrtrr	vijfdaagse werkweek	n.
muntrr	weekeinde	n.
kintrram	vorige week	n.
kintrray	volgende week	n.
muntrram	vorig weekeinde	n.
muntrray	volgend weekeinde	n.
vospxì	maand	n.
vospxìam	vorige maand	n.
vospxìay	volgende maand	n.
sweylu	zouden	v.
ye	tevreden, content, vervuld, verzadigd	adj.
hasey si	volbrengen, tot een eind brengen	vin.
seysonìltsan	goed gedaan! (komt van hasey soli nìltsan goed volbracht)	intj.
yehakx	vol, geen honger meer	adj.
yeväng	dorst gelest, geen dorst meer	adj.
somwew	temperatuur	n.
pup	kort (fysieke lengte)	adj.
ngimpup	lengte	n.
pesomwew	welke temperatuur?	inter.
somwewpe	welke temperatuur? (meer gebruikelijk)	inter.
txawew	erg koud	adj.
wur	koel, kil, fris	adj.
tsyafe	mild, aangenaam	adj.
sang	warm	adj.
txasom	erg heet	adj.
leyapay	nevelig, mistig	adj.
lepwopx	bewolkt	adj.
nìhol	enkele, niet veel	adv.
nìpxay	veel	adv.
paynga'	vochtig, nat	adj.
meuianga'	geëerd, eerbaar	adj.
txumnga'	giftig	adj.
'akra	grond (vruchtbaar)	n.
hufwetsyìp	bries, windje	n.
nìlam	blijkbaar	adv.
nìli	vooruit (van tevoren)	adv.
nìfrakrr	als altijd	adv.
am'a	twijfel	n.
nga'	bevatten	vtr.
tìftang si	(iets of iemand) stoppen	vin.
may'	uitproberen, evalueren, testen, proefdraaien	vtrm.
yora'	winnen	vtr.
snaytx	verliezen (b.v. wedstrijd. Niet: een ding kwijtraken)	vtr.
tìyora'	zege, overwinning	n.
tìsnaytx	verlies	n.
'otxang	muziekinstrument (algemene term)	n.
skxir	wond	n.
leskxir	gewond	adj.
skxir si	verwonden	vin.
skxirtsyìp	snee, schram, kleine verwonding	n.
sloan	gieten (v.e. vloeistof)	vtr.
emrey	overleven	vin.
temrey	overleven	n.
lemrey	overlevende (b.v. leden van een groep waarvan enkele zijn gestorven)	adj.
nemrey	op een manier alsof iemand's leven op het spel staat	adv.,intj.
wawe	betekenis, belang	n.
txanwawe	persoonlijk belangrijk, significant	adj.
nìwawe	betekenisvol, significant	adv.
keyrel	gezichtsuitdrukking	n.
fwampop	tapirus	n.
säplltxe	verklaring, uitdrukking	n.
säplltxevi	commentaar	n.
kawtseng	nergens	adv.
tsapo	die ene (alleen voor mensen)	pn.
fwefwi	fluiten	vin.
'etnaw	schouder	n.
pllngay	toegeven	vin.
kawngsar	uitbuiten	vtr.
lom	missend, vermist (als een nietaanwezig iemand waarnaar verlangd wordt)	adj.
koaktan	oude man	n.
koakte	oude vrouw	n.
koaktu	oud persoon	n.
lomtu	persoon die gemist wordt	n.
fe'	slecht	adj.
nìfe'	slecht	adv.
wätu	opponent, tegenstander	n.
fekem	ongeluk	n.
hawtsyìp	tukje, kort slaapje	n.
uran	boot	n.
ftxozä si	vieren	vin.
kekem	geen actie of activiteit	pn., adv.
pxen	stuk functionele kleding	n.
tewng	lendendoek	n.
raspu'	beenbeschermers (gebruikt in oorlog/strijd)	n.
hawnven	schoen	n.
hawntsyokx	handschoen	n.
hawre'	hoed	n.
ioi	versiering of ceremoniel sieraad	n.
nìlun	uiteraard, vanzelfsprekend, logisch	adv.
'ali'ä	kraag / choker	n.
'are	poncho, cape, sjaal	n.
fkxile	halsketting	n.
masat	borstplaat (bewapening)	n.
nikroi	haarsieraad	n.
pxawpxun	armband	n.
renten	bril (gemaakt van insectenvleugels, gesneden uit hout etc.)	n.
tsamopin	oorlogsbeschildering	n.
tsang	piercing	n.
miktsang	oorbel	n.
ontsang	neusring	n.
yemstokx	aantrekken (kleding)	vtr.
ioi si	verfraaien	vin.
'aku	verwijderen, wegnemen, uittrekken	vtr.
le'aw	enkel	adj.
mawkrra	na (tijd)	conj.
akrrmaw	na (tijd)	conj.
Toitslan	Duitsland	prop.n.
Toitsye	Duits (taal)	adj.
lukpen	zonder kleding, naakt	adj.
fmawnta	dat nieuws	n.
vin	verzoek, vragen om	vtr.
mìftxele	met betrekking tot dit, in dit perspectief	adv.
zìma'uyu	nieuwkomer, iemand die net gearriveerd is	n.
nìvingkap	trouwens, tussen haakjes	adv.
txankrr	voor een lange tijd	adv.
vingkap	een ingeving krijgen, een licht opgaan	vtr.
tìomum	kennis	n.
tinan	lezen	n.
ninan	door te lezen	adv.
tsmìm	spoor (van een dier of persoon)	n.
inan	lezen (b.v. het bos), kennis vergaren via de zintuigen	vtr.
'ä'	oeps!	intj.
teynga	dat antwoord	n.
teyngla	dat antwoord (agentief)	n.
teyngta	dat antwoord (patientief)	n.
fayluta	deze woorden	n.
stxenu	aanbod	n.
tìtstew	moed, dapperheid	n.
tìtstewnga'	moedig, dapper	adj.
stxenutìng	aanbieden	vtr.
tsyär	afwijzen, verwerpen	vtr.
tìtsyär	afwijzing	n.
mll'an	accepteren	vtr.
tìmll'an	acceptatie	n.
kam	geleden	adp.
kay	van nu af aan (in de toekomst)	adp.
'awnìm	vermijden	vtr.
steng	gelijk, identiek	adj.
nìsteng	gelijkend	adv.
nim	timide, schuchter	adj.
srätx	vervelen, lastig vallen	vtr.
säsrätx	ergernis, verveling (door iemand)	n.
rì'ìr	reflectie, spiegelbeeld	n.
rì'ìr si	reflecteren, imiteren	vin.
tsìsyì	fluisteren	vin.
nìwok	luidruchtig	adv.
sätsìsyì	gefluister, fluistering	n.
nìtsìsyì	door te fluisteren, in een fluistering	adv.
nìfwefwi	door te fluiten, fluitend	adv.
lawr	melodie	n.
tìng lawr	zingen zonder woorden, neuriën	vin.
säomum	(stuk) informatie	n.
kosman	geweldig, fantastisch	adj.
nìksman	geweldig (op een geweldige manier)	adv.
letsim	origineel, uniek, niet van een andere bron genomen	adj.
lesngä'i	origineel, eerste in een serie	adj.
nìtsim	origineel, op een originele manier	adv.
nìsngä'i	oorspronkelijk, als begin	adv.
ngong	lethargisch, lui, zonder genoeg energie	adj.
walak	energiek, actief	adj.
tìngong	lethargie, luiheid	n.
txi	haast, gehaastheid	n.
letxi	gehaast	adj.
nìtxi	gehaast, op haastige wijze	adv.
letxiluke	ongehaast	adj.
nìtxiluke	ongehaast, kalm	adv.
kulat	openbaren, voortbrengen (letterlijk, en als metafoor)	vtr.
txantompa	stortbui, zware regen	n.
meyam	omhelzen, in de arm houden	vtr.
sämyam	omhelzing	n.
fìtsap	elkaar	adv.
nuä	voorbij	adp.
kanfpìl	concentreren, de aandacht focussen	vin.
fmokx	jalouzie, nijd	n.
nìfmokx	jaloezie	adv.
kìmar	van dit seizoen (voeding, groente of dierlijk)	adj.
nìkmar	in het juiste seizoen, het juiste moment	adv.
nìngong	lethargisch, lui	adv.
säpom	kus	n.
kxukx	slikken	vtr.
txewm	beangstigend, eng	adj.
hìmpxì	minderheid, minste, klein deel	n.
kawnglan	met slechte intenties	adj.
nutx	dik	adj.
flì	dun	adj.
flìnutx	dikte	n.
sneyä	zijn eigen, haar eigen, diens eigen	pn.
säsyep	val	n.
yora'tu	winnaar	n.
snaytu	verliezer	n.
way a plltxe	gesproken gedicht (als melodieuze voordracht)	ph.
way a rol	gezongen gedicht	ph.
wayä aylì'u	woorden van een gedicht, tekst van een lied	ph.
ultxatu	lid van een bijeenkomst	n.
wo	reiken naar	vtr.
yawo	opstijgen, lanceren	vin.
tsìk	plotseling, zonder waarschuwing	adv.
kllwo	landen, neerkomen (het proces van)	vin.
kllpä	landen, de grond bereiken	vin.
sätswayon	vlucht (het vliegen)	n.
rawn	vervangen, substitueren	vtr.
tìrawn	vervanging, het vervangen	n.
särawn	vervanging, substituut, iets dat iets anders vervangt	n.
kxeltek	oppakken, optillen	vtr.
fngo'	vereisen, nodig hebben	vtr.
säfngo'	voorwaarde, benodigdheid	n.
ngam	echo	n.
slär	grot	n.
ngampam	rijm	n.
ngampam si	rijmen	vin.
faoi	glad	adj.
ekxtxu	ruw	adj.
yo'	perfect zijn, foutloos zijn	svin.
nìyo'	perfect, foutloos	adv.
nìyol	vlot, kort (tijd)	adv.
tìyo'	perfectie	n.
'ipu	humoristisch, leuk, amusant	adj.
tì'ipu	humor	n.
tìfmi	poging	n.
sä'ipu	iets leuks	n.
hangvur	grapje, leuk verhaal	n.
lì'uvan	woordgrap, woordspel	n.
kanom	krijgen, verschaffen	vtr.
säkanom	iets dat verschaft/verkregen is, een bezitting	n.
srìn	doorgeven van een naar een ander (zelden gebruikt zonder prefix)	vtr.
käsrìn	uitlenen (aan iemand)	vtr.
zasrìn	lenen (van iemand)	vtr.
säsrìn	(uit)geleend object	n.
pxìmun'i	verdelen, in stukken snijden	vtr.
lätxayn	verslagen in gevecht, overwinnen	vtr.
sälätxayn	verslaan, een verlies	n.
yll	gezamenlijk	adj.
nìyll	gezamenlijk, op gezamenlijke wijze	adv.
hona	schattig, leuk	adj.
tìhona	leukheid, schattigheid	n.
fäkä	omhoog gaan	vin.
fäza'u	omhoog komen	vin.
kllza'u	omlaag komen	vin.
sämok	suggestie, voorstel	n.
mal	betrouwbaar	adj.
nìmal	vertrouwend, zonder twijfel	adv.
tìmal	betrouwbaarheid	n.
kllyem	begraven	vtr.
nìtsyìl	door te klimmen	adv.
sätsyìl	klimevenement, een klim	n.
rìn	hout	n.
flawkx	leer, leder	n.
'ana	hangende liaan	n.
tsngawpay	tranen	n.
tsngawpayvi	traan	n.
nìhona	schattig, lief	adv.
lepay	waterig	adj.
'ul	verhogen, vermeerderen	vin.
nän	verlagen, verminderen	vin.
nìnän	minder	adv.
nì'ul'ul	meer en meer	adv.
nìnänän	minder en minder	adv.
mek	leeg, ook als metafoor: geen waarde hebbend	adj.
leioae	respect	n.
leioae si	respecteren	vin.
säwìntxu	vertoning, tentoonstelling	n.
tì'i'a	einde, conclusie	n.
srer	verschijnen, materialiseren, in zicht komen	vin.
'ìp	verdwijnen, uit zicht verdwijnen	vin.
tsong	vallei	n.
tsongtsyìp	kuil(tje)	n.
ro'a	indrukwekkend zijn, respect afdwingen	vin.
säro'a	grote daad, iets dat volbracht is	n.
säro'a si	grote daden doen	vin.
txanro'a	beroemd zijn	vin.
velek	opgeven, overgeven, verslagen zijn	vin.
spono	eiland	n.
txew	hoek, rand, limiet, grens, einde	n.
txewnga'	beperkt, begrensd	adj.
litx	scherp (als b.v. een mes)	adj.
fwem	stomp (punt)	adj.
syura	energie (fysiek of spiritueel)	n.
syuratan	bioluminescentie	n.
txonkrr	's nachts	adv.
yuey	mooi (innerlijke schoonheid)	adj.
kxem	verticaal zijn	vin.
txay	horizontaal zijn, plat liggen	vin.
nìkxem	verticaal	adv.
nìtxay	horizontaal	adv.
klltxay	op de grond liggen	vin.
klltxeykay	(iets) op de grond leggen / neerleggen 	vtr.
yo	oppervlak	n.
kxemyo	muur, verticaal oppervlak	n.
fyep	vasthouden, in de hand houden, vastgrijpen	vtr.
nìk'ärìp	vast, onbeweeglijk	adv.
nìklonu	stevig, vol vertrouwen	adv.
nìktungzup	voorzichtig, stevig	adv.
nìsyep	stevig, in een ijzeren greep	adv.
nìmeyp	zwak, losjes	adv.
säfyep	hendel	n.
slan	steunen (emotioneel, sociaal of persoonlijk)	vtr.
tìslan	steun (emotioneel, sociaal, persoonlijk)	n.
tìeyktan	leiderschap	n.
'llngo	heup	n.
zare'	voorhoofd	n.
flawm	wang	n.
prrku	baarmoeder	n.
ngep	navel	n.
tawsyuratan	aurora, noorderlicht	n.
syeha	adem	n.
syeha si	ademen	vin.
sko	iets als, met de capaciteit van/in de rol van iets anders	adp.
sna'o	set, groep, stapel, kluit	n.
snatxärem	skelet	n.
snafpìlfya	filosofie	n.
snatanhì	sterrenstelsel	n.
sästarsìm	collectie (doelbewust door iemand bij elkaar gebracht)	n.
tsu'o	kunde, kunnen	n.
krra	wanneer, op de tijd dat	conj.
snatanhìtsyìp	sterrencluster	n.
pìwopxtsyìp	nevel	n.
tìterkup	dood (abstracte vorm)	n.
maweypeyyu	Iemand die geduldig is	n.
ftxulì'u	oreren, een toespraak houden	vin.
ftxulì'uyu	orator, (publieke) spreker	n.
säftxulì'u	toespraak	n.
tìftxulì'u	toespreken, speechen (specifiek geval)	n.
slantire	inspiratie	n.
slantire si	inspireren	vin.
kum	resultaat	n.
kuma	dat (als een resultaat)	conj.
akum	dat (als een resultaat)	conj.
fyel	verzegelen, ondoordringbaar maken	vtr.
zey	speciaal, apart	adj.
vll	aanwijzen	vin., vtr.
eykyu	leider (tijdelijk, b.v. van een kleine groep als een jachtgroep)	n.
am'ake	zeker, overtuigd	adj.
nam'ake	overtuigd, zeker	adv.
kezemplltxe	uiteraard, hoeft niet gezegd te worden	adv.
tare	verbinden, relateren aan, een relatie hebben met	vtr.
nìsoaia	(samen) als leden van een familie	adv.
nìolo'	(samen) als leden van een stam	adv.
sätare	verbinding, relatie	n.
sloa	wijd	adj.
snep	smal	adj.
slosnep	breedte	n.
peslosnep	welke breedte, hoe breed?	inter.
slosneppe	welke breedte, hoe breed?	inter.
hoet	wijds, uitgebreid	adj.
nìhoet	wijds	adv.
so'ha	enthousiast zijn over, opgewonden zijn over	vtr.
tìso'ha	enthousiasme, een goede instelling hebbend	n.
nìso'ha	enthousiast	adv.
leso'ha	enthousiast	adj.
tsawlultxa	conferentie	n.
zìsìtay	volgend jaar	n.
tìtsunslu	mogelijkheid	n.
numultxa	les (voor instructie)	n.
numultxatu	klasgenoot	n.
snanumultxa	cursus (serie lessen)	n.
tìflä	succes (algemeen)	n.
säflä	succes (een moment van succes)	n.
mesrram	eergisteren, twee dagen geleden	n., adv.
mesrray	overmorgen, over twee dagen	n., adv.
pxesrram	drie dagen geleden	n., adv.
pxesrray	over drie dagen	n., adv.
mong	vertrouwen op	vtr.
sru'	vertrappen, verpletteren	vtr.
'ekxin	strak	adj.
um	los	adj.
'ekxinum	strakheid, losheid	n.
pekxinum	hoe strak, los?	inter.
zeswa	gras	n.
zeswavi	grasspriet	n.
lezeswa	grassig, grasachtig	adj.
lopx	in paniek zijn/raken	vin.
hifwo	vluchten, ontsnappen	vin.
yrrap	storm	n.
'rrpxom	donder, onweer	n.
rawm	bliksem (algemene uitdrukking)	n.
rawmpxom	donder en bliksem	n.
se'ayl	een aparte hoge smalle waterval die van een hoge klip of een zwevende berg stroomt (telbaar)	n.
kxor	een brede bank krachtige watervallen, bekend om de oorverdovende en dodelijke kracht (telbaar, maar komt zelden voor)	n.
syanan	een enkele, of serie van kleinere watervallen, natuurlijk voorkomend langs een stroom of serie plassen (telbaar)	n.
rurur	een waterstroom met veel luchtcontact terwijl het over rotsen van een geleidelijk neergaande stroom gaat (telbaar)	n.
tseltsul	stroomversnelling (telbaar, komt zelden voor)	n.
tìmeyp	zwakheid	n.
am'aluke	zonder twijfel	adv.
atanzaw	gevorkte bliksem	n.
nìsìlpey	hopelijk	adv.
talun	vanwege	adp.
nìTsyungwen	Zhongyuan	adv.
reykol	muziek maken, laten zingen (dichterlijk)	vtr.
nrra	trots, gevoel van trots	n.
lenrra	trots	adj.
nìnrra	trots, met trots	adv.
snonrra	zelftrots (negatieve benadering)	n.
lesnonrra	vol zelftrots	adj.
nrr	gloeien, lichtgevend zijn	vin.
ylltxep	gezamenlijk vuur of vuurplek	n.
txeptseng	plek waar vuur brandt of heeft gebrand	n.
ralnga'	betekenisvol, instruerend, iets waar een les uit kan worden geleerd	adj.
munsna	paar	n.
fyin	simpel, eenvoudig	adj.
ep'ang	complex, ingewikkeld	adj.
epxang	stenen pot die een kleine giftige spinachtige bevat	n.
fyinep'ang	graad van complexiteit	n.
pefyinep'ang	hoe complex?	inter.
fyinep'angpe	hoe complex?	inter.
sngä'itseng	begin, startpositie, initiele plek	n.
srungsiyu	assistent, helper	n.
srungtsyìp	tip, helpende hint	n.
spulmokri	telefoon	n.
syeprel	camera	n.
swoa	bedwelmende drank, geestrijk vocht	n.
rou	dronken zijn of worden	vin.
pamrelvi	letter (fonetisch symbool)	n.
snapamrelvi	alfabet	n.
tìtxen si	wakker worden	vin.
fnetxum	allergeen	n.
zet	gedragen (emotioneel), een air hebben jegens	vtr.
ha'	passen, aanvullen, verbeteren	vin.
syon	onderdeel, attribuut, karaktertrek, aspect, facet	n.
ran	natuur, essentie; basis natuur van iets wat volgt uit het totaal van diens onderdelen; het best vertaald als 'persoonlijkheid'	n.
fyole	subliem, voorbij perfectie	adj.
loran	elegantie, gratie	n.
fe'ran	beschadigde natuur/basis, iets dat slecht ontvangen wordt of beschadigd	n.
reyfya	manier van leven, cultuur	n.
fe'ranvi	blaam, misvorming, vlek	n.
nìran	in de basis/essentie, fundamenteel	adv.
mo	ruimte, ommuurd open gebied	n.
snomo	persoonlijke ruimte om zich in terug te trekken	n.
wum	ongeveer, ruwweg	adv.
kesran	zozo, matig	adj.
nìksran	op een matige/gemiddelde wijze	adv.
yewla	teleurstelling, emotionele afknapper, niet aan verwachting voldaan	n.
leyewla	teleurstellend	adj.
nìyewla	op een teleurstellende wijze	adv.
yawnyewla	gebroken hart, staat van gebroken hart hebbend	n.
ve'o	orde (tegenover wanorde of chaos), organisatie	n.
vezo	op orde zijn, georganiseerd zijn	vin.
vezeyko	op orde brengen, organiseren	vtr.
vefya	systeem, proces, procedure, benadering	n.
velke	chaotisch, rommelig, ongeorganiseerd, puinhoop	adj.
venga'	georganiseerd, alles in de hand hebbend	adj.
nìfnu	stilletjes	adv.
sätaron	jacht	n.
wäsul	wedijveren, deelnemen aan wedstrijd	vin.
tìwäsul	competitie	n.
säwäsul	een competitie	n.
säwäsultsyìp	een wedstrijd	n.
tìmwiä	eerlijkheid, rechtvaardigheid	n.
snew	beperken, vast(er) maken	vtr.
txantxew	maximum	n.
snewsye	vreemd, eng	adj.
hìmtxew	minimum	n.
txantxewvay	maximaal	adv.
hìmtxewvay	minimaal	adv.
hefi	ruiken (niet doelbewust)	vtr.
ewku	proeven (niet doelbewust)	vtr.
zìm	voelen (niet doelbewust)	vtr.
yune	luisteren naar (doelbewust)	vtr.
syam	ruiken (doelbewust)	vtr.
'ur	zicht, uitzicht, aangezicht	n.
sur	smaak	n.
zir	gevoel, tekstuur, aanraking	n.
tse'atswo	zien, zicht (zintuig)	n.
stawmtswo	gehoor (zintuig)	n.
hefitswo	reuk (zintuig)	n.
ewktswo	smaak (zintuig)	n.
zìmtswo	tast (zintuig)	n.
fkan	zich voelen als	vin.
onlor	goedruikend	adj.
onvä'	slechtruikend	adj.
we'ay	zuur	adj.
wip	zout	adj.
fwang	hartig, umami, rijk van smaak	adj.
nget	geur van rottend hout en bladeren, muf (nietdierlijk verval)	adj.
kxänäng	geur van rottend dier/vlees	adj.
sosul	plezierige geur van nabij stromend water, regen, natte vegetatie	adj.
unyor	zoet aromatisch (evt. ook Na'vi kruiden voor bij het koken)	adj.
atxar	geur van levende dieren, zoals bij een drinkgebied	adj.
inanfya	zintuig	n.
uvan letokx	lichamelijk of atletisch spel, sport	n.
ftärpa	linkerkant	n.
skiempa	rechterkant	n.
rengop	ontwerpen	vtr.
tìrengop	ontwerp (het doen, het ontwerpen)	n.
särengop	ontwerp (specifiek geval)	n.
ingyen	gevoel van mysterie of verwarring	n.
sngumtsim	iets wat je zorgen baart	n.
yayayrtsim	iets verwarrends	n.
ingyentsim	mysterie, raadsel	n.
ingyentsyìp	truuk, kunstje, vingervlugheid	n.
ningyen	mysterieus	adv.
ingyenga'	mysterieus	adj.
sngunga'	zorgelijk, zorgbarend	adj.
yayayrnga'	verwarrend	adj.
yrr	wild, natuurlijk (iets in natuurlijke, onaangetaste staat)	adj.
nìyrr	natuurlijk, onveranderd, puur	adv.
zäfi	veranderd, niet langer natuurlijk	adj.
syor	ontspannen	vin.
tìsyor	ontspanning	n.
tìfnunga'	stil	adj.
späpeng	jezelf heropbouwen (metaforisch)	vin.
'anla	verlangen naar	vtr.
sä'anla	verlangen	n.
lie	ervaring	n.
tsìlpey	hoop (abstract idee)	n.
säsìlpey	hoop (specifiek geval)	n.
kelsar	nutteloos	adj.
yì	plank, trede, rand, niveau	n.
snayì	trap, serie tredes	n.
kxaylyì	hoog niveau	n.
kxamyì	gemiddeld niveau	n.
tìmyì	laag niveau	n.
flrr	vriendelijk, mild, teder (mensen of dingen)	adj.
nìflrr	vriendelijk, teder	adv.
tìflrr	tederheid, vriendelijkheid	n.
ngä'än	mentaal of emotioneel lijden, miserabel voelen	vin.
kelkin	onnodig	adj.
nìkelkin	onnodig	adv.
sängä'än	periode van lijden, periode van depressie	n.
'eylanay	bekende (met potentieel een vriend te worden)	n.
eyktanay	onderbaas, één stap onder leider	n.
tsulfätunay	bijnameester	n.
karyunay	leraar in opleiding	n.
tsan'ul	verbeteren, beter worden	vin.
fe'ul	verslechteren, slechter worden	vin.
tìtsan'ul	verbetering (algemeen, abstract)	n.
tìfe'ul	verslechtering (algemeen, abstract)	n.
sätsan'ul	verbetering	n.
säfe'ul	verslechtering (specifiek geval)	n.
frafya	op elke manier	adv.
postì	artikel (op een forum/blog)	n.
ketsran	hoe dan ook	adj.,  conj.
kangay si	valideren, bevestigen	vin.
txurtel	touw	n.
ropx	gat (gaat dwars door object heen)	n.
tsongropx	gat, uitsparing, uitgraving met een bodem (zichtbaar of aangenomen)	n.
tsrul	nest; beschermd gebied voor fauna van Pandora	n.
yayotsrul	vogelnest	n.
lini	jong (van een dier, vogel, vis, insect)	n.
tarnioang	roofdier	n.
rong	tunnel	n.
swek	staaf, paal	n.
mektseng	opening, breuk	n.
tsenga	waar, plaats waar	conj.
fta	knoop	n.
fta si	knopen, een knoop maken	vin.
fwi	uitglijden, glijden	vin.
oìsss si	sissen	vin.
il	buigen	vin.
kxakx	breken, in twee delen breken	vin.
ftumfa	vanuit, vanuit de binnenkant van	adp.
sä'eoio	ceremonie, ritueel, rite	n.
sä'eoio si	meedoen met een ceremonie, een rtitueel doen	vin.
kur	hangen	vin.
nìtkan	met opzet	adv.
nìtkanluke	per ongeluk, onbedoeld	adv.
nui	falen, fout gaan, niet het beoogde doel behalen	vin.
nìnu	falend, voor niets, vruchteloos, niet het gewilde of verwachte eind halend	adv.
tìnui	fiasco (abstract)	n.
sänui	fiasco (specifiek incident)	n.
fngä'	zich ontlasten (Op aarde: naar het toilet gaan)	vin.
zun	als (contrafeitelijk gebruik)	conj.
zel	dan (contrafeitelijk gebruik)	adv.
'ekxinumpe	hoe vast, los?	inter.
okup	melk	n.
loi	ei	n.
tsyeym	schat; iets zeldzaams en van grote waarde	n.
wokau	penduletrom	n.
srä	doek; een stuf stof geweven op een weefgetouw	n.
srok	kraal (decoratief)	n.
pxayopin	kleurrijk, bont	adj.
tsyoklìt	chocolade	n.
paynäpll	ananas	n.
pamrelsiyu	schrijver	n.
rel arusikx	film, video	n.
lì'upuk	woordenboek	n.
lì'upuk	woordenboek	n.
nìkemweypey	ongeduldig	adv.
kelemweypey	ongeduldig	adj.
'on	vorm	n.
salewfya	richting, koers	n.
koum	rond, gebogen	adj.
ko'on	ring, ovaal, ongeveer ronde gesloten vorm	n.
yo'ko	cirkel	n.
renulke	onregelmatig, random	adj.
vawt	vast, solide, niet hol	adj.
momek	hol, niet solide	adj.
yeyfya	rechte lijn	n.
yak	vork, vertakking, punt van afwijking	n.
yak si	divergeren, koers wijzigen, afwijken	vin.
nìyeyfya	recht vooruit, in een rechte lijn	adv.
nìftär	naar links	adv.
nìskien	naar rechts	adv.
'oratsyìp	plas, poel	n.
nìyawr	correct, juist	adv.
tìsteftxaw	onderzoek	n.
yoa	in ruil voor	adp.
txolar	dollar	n.
ewro	euro	n.
lawnol	grote vreugde	n.
ley	waarde hebben, iets waard zijn	vin.
säfmi	poging	n.
nìfkeytongay	eigenlijk, feitelijk	adv.
mowar	advies	n.
mowar si	adviseren	vin.
mowarsiyu	adviseur	n.
kakpam	doof	adj.
tìkakpam	doofheid	n.
pxek	trappen, duwen	vtr.
kolan	ik bedoel, eigenlijk (zichzelf corrigerend)	intj.
hena	dragen	vtr.
sähena	drager (b.v. een pot of mand)	n.
paysena	watervat	n.
tutsena	brancard	n.
tstalsena	schede (van een mes)	n.
swizawsena	pijlkoker (bevestigd aan ikranzadel)	n.
tìkakrel	blindheid	n.
ngoa	modder	n.
mawfwa	nadat	conj.
neni	zand	n.
fwep	stof (op een oppervlak)	n.
fwopx	stof (in de lucht)	n.
nìyey	direct, meteen terzake	adv.
'al	verspillen	vtr.
tì'al	verspilling	n.
le'al	verspillend	adj.
nì'al	verspillend	adv.
srey	versie	n.
lupra	stijl	n.
fyolup	subliem in stijl, exquise	adj.
fe'lup	goedkoop, smakeloos	adj.
snolup	persoonlijke stijl, aanwezigheid	n.
'ongop	ontwerpen	vtr.
'ongopyu	ontwerper	n.
uniltìrantokxolo'	clan of groep Avatars	n.
krrka	tijdens	adp.
tìreyn	trein	n.
LosÄntsyelesì	Los Angeles	pn.
tson	plicht, verplicting, opgelegd vereiste	n.
nìtson	plichtig, als een verplichting	adv.
kxìm	commanderen, bevelen, taken uitdelen	vtr.
tsonta	(om) te (met kxìm)	conj.
tìkxìm	gecommandeer	n.
tìkxìm si	boven iemand staan (in hierarchie)	vin.
kxìmyu	aanvoerder, iemand die authoriteit over anderen heeft	n.
saylahe	'et cetera'	adv.
fpomron	gezondheid of welzijn (mentaal)	n.
lefpomron	gezond (mentaal)	adj.
kelfpomron	ongezond (mentaal)	adj.
fpomtokxnga'	gezond (fysiek)	adj.
kefpomtokxnga'	ongezond (fysiek)	adj.
fpomronga'	gezond (mentaal)	adj.
kefpomronga'	ongezond (mentaal)	adj.
srefpìl	aannemen	vtr.
srefwa	voordat	conj.
ken'aw	niet alleen	adv.
släkop	maar ook	adv.
sngum si	zich zorgen maken	vin.
väpam	lawaai, onaangenaam of schel geluid	n.
hawmpam	lawaai, een excessief, onnodig, ongepast, onverwachts of ontstellend geluid	n.
lehawmpam	lawaaierig	adj.
nìhawmpam	lawaaierig	adv.
miklor	aangenaam aanhorend, mooi klinkend	adj.
mikvä'	slecht klinkend	adj.
narlor	visueel mooi	adj.
narvä'	lelijk, afzichtelijk	adj.
zawr	dierlijke roep	n.
tìnew	verlangen	n.
nopx	wegstoppen, opbergen	vtr.
tiam	tellen	vtr.
ketsuktiam	ontelbaar, oneindig	adj.
txewluke	eindeloos, zonder grenzen, zonder limiet	adj.
'umtsa	medicijn	n.
lang	onderzoeken, verkennen	vtr.
tìlang	onderzoek	n.
sälang	een ontdekkingsreis of onderzoek	n.
kxum	visceus, gelatineachtig, dik	adj.
kxumpay	visceuse vloeistof, gel	n.
sängop	creatie	n.
tsyìl	klimmen, beklimmen (gehele lichaam optillen)	vtr.
kxap	bedreiging	n.
kxapnga'	bedreigend	adj.
nìkxap	bedreigend	adv.
tìftiatu	onderzoeker	n.
tìftiatu kifkeyä	wetenschapper	n.
heyr	borstkas	n.
tseri	opmerken	vtr.
kxap si	bedreigen	vin.
tìtseri	besef, opmerkzaamheid	n.
tìktseri	gebrek aan besef, onopmerkzaamheid	n.
yäkx	niet opmerken, negeren	vtr.
tìyäkx	gebrek aan besef, (het) negeren	n.
srunga'	behulpzaam	adj.
säyäkx	(het) negeren	n.
ngip	ruimte, open of grenzeloos gebied	n.
txepram	vulkaan	n.
txekxumpay	magma, lava	n.
wrrza'u	uitkomen	vin.
tskxevi	kiezel, kleine door natuurlijke krachten gepolijste steen	n.
nìkx	grind	n.
tìralpeng	vertaling, interpretatie	n.
unil si	dromen	vin.
uniltsa	dromen van, dromen over	vtr.
mauti	fruit	n.
utu	bladerdak	n.
utumauti	bananenfruit	n.
slayk	borstelen, kammen	vtr.
tìkelu	gebrek	n.
tompakel	droogte	n.
syuvekel	hongersnood	n.
zawprrte'	plezierig zijn	vin.
nawri	getalenteerd	adj.
tìnawri	talent	n.
susyang	fragiel, delicaat	adj.
reym	droog land (op het droge)	n.
kop	en ook	conj.
tuvom	het geweldigst van alles, het meest geweldige	adj.
yengwal	droefheid, smart	n.
nip	vast komen te zitten, ergens in gevangen raken	vin.
hän	net, web	n.
'rrko	rollen	vin.
tsngem	spier	n.
tsawsngem	gespierd	adj.
wìngay	bewijzen	vtr.
tìwìngay	bewijs, het bewijzen (abstract)	n.
säwìngay	bewijs (specifiek bewijs)	n.
tìng zekwä	aanraken (doelbewust)	vin.
weptseng	website	n.
wep	web (als in wereldwijde web, www)	n.
tseotu	kunstenaar (algemene term), artiest	n.
tìkeftxo	droefheid, verdriet	n.
tìkeftxonga'	verdrietig	adj.
pamtseongopyu	muzikant, componist	n.
lereyfya	cultureel	adj.
huru	pan, ketel	n.
sey	beker, kom (minimaal aangepaste natuurlijke bronnen)	n.
'e'in	kalebas	n.
'e'insey	beker (gemaakt van een kalebas)	n.
sum	schelp	n.
sumsey	beker (gemaakt van een schelp)	n.
swoasey	kava kom (gemaakt uit peulvruchten, gebruikt om bedwelmende drank te drinken, handdraagbaar)	n.
swoasey ayll	grote sociale kava kom (gemaakt uit peulvruchten, gebruikt om bedwelmende drank te drinken)	n.
tsyey	snack, lichte maaltijd	n.
tsyeytsyìp	klein hapje	n.
nik	handig, bruikbaar zonder veel moeite	adj.
niktsyey	eetbare wrap (voedsel ingewikkeld in eetbare bladeren of lianen)	n.
merki	rek/rooster op de grond (om vlees te roken)	n.
ikut	grote stamper (maalgereedschap); vleesstamppaal	n.
sämunge	transportinstrument of apparaat	n.
syusmung	dienblad	n.
paysmung	waterdrager	n.
prrsmung	baby drager	n.
nivi	slaap hangmat (algemene term)	n.
swaynivi	familie hangmat	n.
snonivi	éénpersoons hangmat	n.
sänrr	gloed; lichtbron, lamp	n.
tsmi	nectar	n.
tsmisnrr	blaaslantaarn, nectar lantaarn	n.
seyn	stoel, kruk, bank; een voorwerp waarop gezeten kan worden	n.
hoan	comfort	n.
lehoan	comfortabel	adj.
nìhoan	comfortabel	adv.
kelhoan	oncomfortabel	adj.
fyan	constructie bedoeld om iets schoon en van de grond te houden	n.
fyanyo	tafel, verhoogd werkblad	n.
yomyo	bord (voor voedsel)	n.
yomyo lerìk	bord uit bladeren	n.
fyanyì	rek, plank	n.
kurfyan	mand of opgehangen rek	n.
snokfyan	rek voor persoonlijke bezittingen	n.
kurfyavi	haak (om iets aan op te hangen)	n.
seyto	slachten (het separeren of verwerken van het karkas van een dood dier)	vtr.
säseyto	slachtgereedschap	n.
yaney	kano	n.
spulyaney	kano peddel	n.
lal	oud (tegenovergestelde van mip)	adj.
txanlal	antiek, heel oud	adj.
tsankum	voordeel, winst	n.
tsankumnga'	voordelig	adj.
fekumnga'	nadelig	adj.
tìmungwrr	uitzondering	n.
tìmungwrr si	een uitzondering maken	vin.
nawfwe	vloeiend (in een taal)	adj.
fekum	nadeel, verlies	n.
plltxeyu	spreker	n.
pxawngip	omgeving	n.
palulukantsyìp	cat (aards dier); let. kleine thanator	n.
zum	voorwerp, ding (fysiek of tastbaar)	n.
hìpey	aarzelen, voor een korte tijd terughouden	vin.
tìhìpey	aarzeling	n.
snäm	rotten, vergaan, afbreken over tijd	vin.
kllrikx	aardbeving	n.
sälatem	verandering (moment van), wijziging, aanpassing	n.
tìlatem	verandering (abstract concept)	n.
txatx	bubbel	n.
lehìpey	aarzelend, in een staat van aarzeling	adj.
nìhìpey	aarzelend	adv.
ronguway	huilen	vin.
ronguwayyu	huiler, iemand die huilt	n.
ler	stabiel, gestaag (voor beweging)	adj.
nìler	stabiel, gestaag	adv.
lo'a	totem, amulet	n.
'ewrang	weefgetouw	n.
sa'ewrang	moederweefgetouw, gigantisch weefgetouw	n.
tiretu	sjamaan	n.
pasuk	bes	n.
vozampasukut	duizend bessen boom	n.
paskalin	zoet besje (koosnaam)	n.
fngä'tseng	toilet (op Aarde)	n.
mo a fngä'	toilet (op Aarde)	n.
sa	een uitdaging aangaan	vin.
tanleng	boomschors	n.
syokup	gewicht (fysiek)	n.
kewan	leeftijd	n.
tìnvi	taak, klus, stap (in een instructie)	n.
tìnvi si	een taak uitvoeren, een klus doen	vin.
txanwetseng	persoonlijk belangrijke of geliefde plaats, Heimat (Duits)	n.
penghrr	waarschuwen	vin.
säpenghrr	waarschuwing	n.
tì'ul	toename	n.
eyawrfya	juiste manier (om iets te doen), correcte pad	n.
stiwi	kattekwaad	n.
stiwi si	ondeugend zijn, kattekwaad uithalen	vin.
stiwinga'	ondeugend	adj.
stiwisiyu	ondeugd	n.
rawng	ingang, deuropening	n.
syewe	vet (in vlees)	n.
syewenga'	vettig	adj.
laro si	schoonmaken, vuiligheid weghalen	vin.
slukx	hoorn van een dier	n.
tsin	nagel, klauw	n.
ue'	braken, vomiteren	vtr., vin.
nantangtsyìp	hond (aards dier); let. kleine nantang	n.
hiup	spugen, uitspugen	vin., vtr.
räptum	grof, vulgair, sociaal onacceptabel	adj.
txanlokxe	domein van een stam of clan, land	n.
tsamsä'o	oorlogswapen	n.
tìtxurnga'	machtig	adj.
leym	roepen, (uit)schreeuwen	vim.
nìzen	noodzakelijk	adv.
kenzen	niet noodzakelijk	adv.
pllhrr	waarschuwen	vin.
säpllhrr	waarschuwing	n.
tspìng	austrapoot	n.
mawup	turtapoot	n.
pawk	hoorn, blaasinstrument	n.
tekre	schedel	n.
ionar	harpijrijder oogkleppen	n.
